start_date,creation_date,sell_date,create-sell,start-create,start-sell
7/20/2004,7/20/2004,8/12/2004,23,0,23
7/9/2004,7/23/2004,8/12/2004,20,14,34
7/23/2004,7/23/2004,8/17/2004,25,0,25
6/9/2004,7/23/2004,7/13/2004,-10,44,34
6/9/2004,7/23/2004,7/13/2004,-10,44,34
7/7/2004,7/26/2004,8/10/2004,15,19,34
7/6/2004,7/26/2004,8/9/2004,14,20,34
7/6/2004,7/26/2004,8/9/2004,14,20,34
4/19/2004,7/26/2004,7/20/2004,-6,98,92
4/14/2004,7/27/2004,7/13/2004,-14,104,90
6/11/2004,8/4/2004,7/16/2004,-19,54,35
8/5/2004,8/5/2004,9/8/2004,34,0,34
8/5/2004,8/5/2004,9/8/2004,34,0,34
8/9/2004,8/9/2004,9/9/2004,31,0,31
5/11/2004,8/10/2004,8/12/2004,2,91,93
8/10/2004,8/10/2004,9/13/2004,34,0,34
8/10/2004,8/10/2004,9/13/2004,34,0,34
8/11/2004,8/11/2004,9/14/2004,34,0,34
7/20/2004,8/11/2004,8/27/2004,16,22,38
8/12/2004,8/12/2004,9/15/2004,34,0,34
8/12/2004,8/12/2004,9/15/2004,34,0,34
8/25/2004,8/25/2004,9/29/2004,35,0,35
9/6/2004,9/6/2004,10/8/2004,32,0,32
9/7/2004,9/7/2004,10/11/2004,34,0,34
9/9/2004,9/9/2004,12/14/2004,96,0,96
9/9/2004,9/9/2004,10/13/2004,34,0,34
9/9/2004,9/9/2004,10/13/2004,34,0,34
9/10/2004,9/10/2004,10/14/2004,34,0,34
9/10/2004,9/10/2004,10/14/2004,34,0,34
9/13/2004,9/13/2004,10/15/2004,32,0,32
10/6/2004,10/6/2004,11/9/2004,34,0,34
10/11/2004,10/11/2004,11/15/2004,35,0,35
10/7/2004,10/7/2004,11/10/2004,34,0,34
10/11/2004,10/11/2004,11/15/2004,35,0,35
10/11/2004,10/11/2004,1/14/2005,95,0,95
10/11/2004,10/11/2004,11/15/2004,35,0,35
10/12/2004,10/12/2004,11/16/2004,35,0,35
10/15/2004,10/15/2004,1/19/2005,96,0,96
10/27/2004,10/27/2004,11/29/2004,33,0,33
8/13/2004,10/27/2004,9/16/2004,-41,75,34
10/27/2004,10/27/2004,10/18/2004,-9,0,-9
10/27/2004,10/27/2004,11/18/2004,22,0,22
9/29/2004,10/28/2004,10/29/2004,1,29,30
10/28/2004,10/28/2004,10/15/2004,-13,0,-13
10/15/2004,10/28/2004,11/18/2004,21,13,34
9/14/2004,10/28/2004,10/18/2004,-10,44,34
10/13/2004,10/29/2004,11/17/2004,19,16,35
10/13/2004,10/29/2004,11/17/2004,19,16,35
11/5/2004,11/5/2004,12/8/2004,33,0,33
11/5/2004,11/5/2004,12/8/2004,33,0,33
9/15/2004,11/8/2004,10/15/2004,-24,54,30
8/15/2004,11/8/2004,9/15/2004,-54,85,31
10/8/2004,11/8/2004,11/12/2004,4,31,35
10/13/2004,11/9/2004,1/17/2005,69,27,96
11/9/2004,11/9/2004,12/13/2004,34,0,34
11/10/2004,11/10/2004,12/13/2004,33,0,33
11/12/2004,11/12/2004,2/11/2005,91,0,91
11/12/2004,11/12/2004,10/25/2004,-18,0,-18
11/12/2004,11/12/2004,1/25/2005,74,0,74
11/15/2004,11/15/2004,12/15/2004,30,0,30
11/15/2004,11/15/2004,12/16/2004,31,0,31
11/16/2004,11/16/2004,12/16/2004,30,0,30
11/16/2004,11/16/2004,12/15/2004,29,0,29
8/10/2004,11/22/2004,9/13/2004,-70,104,34
11/22/2004,11/22/2004,12/15/2004,23,0,23
11/22/2004,11/22/2004,12/13/2004,21,0,21
11/25/2004,11/25/2004,12/30/2004,35,0,35
12/6/2004,12/6/2004,1/10/2005,35,0,35
12/9/2004,12/9/2004,1/13/2005,35,0,35
12/10/2004,12/10/2004,1/14/2005,35,0,35
12/10/2004,12/10/2004,3/11/2005,91,0,91
12/13/2004,12/13/2004,1/17/2005,35,0,35
12/13/2004,12/13/2004,1/13/2005,31,0,31
12/14/2004,12/14/2004,1/17/2005,34,0,34
12/14/2004,12/14/2004,1/18/2005,35,0,35
12/14/2004,12/14/2004,1/20/2005,37,0,37
12/13/2004,12/15/2004,1/13/2005,29,2,31
12/15/2004,12/15/2004,1/17/2005,33,0,33
12/29/2004,12/29/2004,1/31/2005,33,0,33
1/6/2005,1/6/2005,2/8/2005,33,0,33
1/6/2005,1/6/2005,2/8/2005,33,0,33
1/7/2005,1/7/2005,2/9/2005,33,0,33
1/10/2005,1/10/2005,2/9/2005,30,0,30
1/12/2005,1/12/2005,2/11/2005,30,0,30
1/12/2005,1/12/2005,2/14/2005,33,0,33
1/13/2005,1/13/2005,2/15/2005,33,0,33
1/13/2005,1/13/2005,4/15/2005,92,0,92
1/13/2005,1/13/2005,2/17/2005,35,0,35
1/13/2005,1/13/2005,2/17/2005,35,0,35
1/14/2005,1/14/2005,2/16/2005,33,0,33
1/17/2005,1/17/2005,4/19/2005,92,0,92
1/13/2005,1/13/2005,2/15/2005,33,0,33
1/19/2005,1/19/2005,2/16/2005,28,0,28
1/24/2005,1/24/2005,4/25/2005,91,0,91
1/26/2005,1/26/2005,3/1/2005,34,0,34
1/27/2005,1/27/2005,2/28/2005,32,0,32
2/4/2005,2/4/2005,3/8/2005,32,0,32
2/8/2005,2/8/2005,3/9/2005,29,0,29
2/8/2005,2/8/2005,3/10/2005,30,0,30
2/9/2005,2/9/2005,3/11/2005,30,0,30
2/9/2005,2/9/2005,3/11/2005,30,0,30
2/10/2005,2/10/2005,3/14/2005,32,0,32
2/11/2005,2/11/2005,3/15/2005,32,0,32
2/15/2005,2/15/2005,3/17/2005,30,0,30
2/15/2005,2/15/2005,3/15/2005,28,0,28
2/15/2005,2/15/2005,3/15/2005,28,0,28
2/24/2005,2/24/2005,2/18/2005,-6,0,-6
2/24/2005,2/24/2005,2/18/2005,-6,0,-6
2/24/2005,2/24/2005,3/31/2005,35,0,35
2/24/2005,2/24/2005,3/4/2005,8,0,8
2/24/2005,2/24/2005,3/4/2005,8,0,8
2/24/2005,2/24/2005,3/4/2005,8,0,8
3/2/2005,3/2/2005,4/6/2005,35,0,35
2/24/2005,2/24/2005,2/18/2005,-6,0,-6
2/25/2005,2/25/2005,3/31/2005,34,0,34
3/2/2005,3/2/2005,4/6/2005,35,0,35
3/2/2005,3/2/2005,4/6/2005,35,0,35
3/4/2005,3/4/2005,4/8/2005,35,0,35
3/4/2005,3/4/2005,4/8/2005,35,0,35
3/7/2005,3/7/2005,4/11/2005,35,0,35
3/7/2005,3/7/2005,4/11/2005,35,0,35
3/8/2005,3/8/2005,4/12/2005,35,0,35
3/9/2005,3/9/2005,4/13/2005,35,0,35
3/9/2005,3/9/2005,5/13/2005,65,0,65
3/11/2005,3/11/2005,4/15/2005,35,0,35
3/14/2005,3/14/2005,4/18/2005,35,0,35
3/15/2005,3/15/2005,4/15/2005,31,0,31
3/15/2005,3/15/2005,4/15/2005,31,0,31
3/16/2005,3/16/2005,4/6/2005,21,0,21
3/16/2005,3/16/2005,4/20/2005,35,0,35
3/29/2005,3/29/2005,4/29/2005,31,0,31
4/5/2005,4/5/2005,5/9/2005,34,0,34
4/5/2005,4/5/2005,5/9/2005,34,0,34
4/6/2005,4/6/2005,5/10/2005,34,0,34
4/7/2005,4/7/2005,5/12/2005,35,0,35
4/8/2005,4/8/2005,5/11/2005,33,0,33
4/8/2005,4/8/2005,5/12/2005,34,0,34
4/11/2005,4/11/2005,6/13/2005,63,0,63
4/11/2005,4/11/2005,5/13/2005,32,0,32
4/12/2005,4/12/2005,5/17/2005,35,0,35
4/13/2005,4/13/2005,5/16/2005,33,0,33
4/13/2005,4/13/2005,7/18/2005,96,0,96
4/13/2005,4/13/2005,5/17/2005,34,0,34
4/15/2005,4/15/2005,7/20/2005,96,0,96
4/18/2005,4/18/2005,5/19/2005,31,0,31
4/18/2005,4/18/2005,5/19/2005,31,0,31
4/21/2005,4/21/2005,7/25/2005,95,0,95
4/27/2005,4/27/2005,5/30/2005,33,0,33
5/2/2005,5/2/2005,2/25/2005,-66,0,-66
5/2/2005,5/2/2005,2/25/2005,-66,0,-66
5/2/2005,5/2/2005,3/30/2005,-33,0,-33
5/4/2005,5/4/2005,6/6/2005,33,0,33
5/6/2005,5/6/2005,6/8/2005,33,0,33
5/10/2005,5/10/2005,6/13/2005,34,0,34
5/11/2005,5/11/2005,6/13/2005,33,0,33
5/11/2005,5/11/2005,6/14/2005,34,0,34
5/11/2005,5/11/2005,6/13/2005,33,0,33
5/12/2005,5/12/2005,6/15/2005,34,0,34
5/12/2005,5/12/2005,6/14/2005,33,0,33
5/12/2005,5/12/2005,6/15/2005,34,0,34
5/17/2005,5/17/2005,6/16/2005,30,0,30
5/17/2005,5/17/2005,6/20/2005,34,0,34
5/17/2005,5/17/2005,6/20/2005,34,0,34
5/18/2005,5/18/2005,6/16/2005,29,0,29
5/24/2005,5/24/2005,5/27/2005,3,0,3
5/25/2005,5/25/2005,6/29/2005,35,0,35
6/2/2005,6/2/2005,7/7/2005,35,0,35
6/2/2005,6/2/2005,7/7/2005,35,0,35
6/6/2005,6/6/2005,7/8/2005,32,0,32
6/6/2005,6/6/2005,7/8/2005,32,0,32
6/7/2005,6/7/2005,7/11/2005,34,0,34
6/9/2005,6/9/2005,6/29/2005,20,0,20
6/9/2005,6/9/2005,7/13/2005,34,0,34
6/10/2005,6/10/2005,7/13/2005,33,0,33
6/13/2005,6/13/2005,7/15/2005,32,0,32
6/14/2005,6/14/2005,7/19/2005,35,0,35
6/14/2005,6/14/2005,7/18/2005,34,0,34
6/15/2005,6/15/2005,7/19/2005,34,0,34
6/16/2005,6/16/2005,7/7/2005,21,0,21
6/21/2005,6/21/2005,7/12/2005,21,0,21
6/27/2005,6/27/2005,7/29/2005,32,0,32
6/28/2005,6/28/2005,7/29/2005,31,0,31
7/5/2005,7/5/2005,7/22/2005,17,0,17
7/6/2005,7/6/2005,8/8/2005,33,0,33
7/7/2005,7/7/2005,8/9/2005,33,0,33
7/7/2005,7/7/2005,8/9/2005,33,0,33
7/11/2005,7/11/2005,8/1/2005,21,0,21
7/12/2005,7/12/2005,8/12/2005,31,0,31
7/12/2005,7/12/2005,8/16/2005,35,0,35
7/13/2005,7/13/2005,8/16/2005,34,0,34
7/13/2005,7/13/2005,10/17/2005,96,0,96
7/13/2005,7/13/2005,8/18/2005,36,0,36
7/15/2005,7/15/2005,8/16/2005,32,0,32
7/18/2005,7/18/2005,10/19/2005,93,0,93
7/20/2005,7/20/2005,8/11/2005,22,0,22
7/20/2005,7/20/2005,8/25/2005,36,0,36
7/27/2005,7/27/2005,8/30/2005,34,0,34
8/4/2005,8/4/2005,9/8/2005,35,0,35
8/4/2005,8/4/2005,9/8/2005,35,0,35
8/5/2005,8/5/2005,9/9/2005,35,0,35
8/8/2005,8/8/2005,8/12/2005,4,0,4
8/9/2005,8/9/2005,9/13/2005,35,0,35
8/9/2005,8/9/2005,9/13/2005,35,0,35
8/9/2005,8/9/2005,9/13/2005,35,0,35
8/10/2005,8/10/2005,9/14/2005,35,0,35
8/11/2005,8/11/2005,9/15/2005,35,0,35
8/12/2005,8/12/2005,9/15/2005,34,0,34
8/12/2005,8/12/2005,9/16/2005,35,0,35
8/23/2005,8/23/2005,9/27/2005,35,0,35
8/23/2005,8/23/2005,9/27/2005,35,0,35
8/25/2005,8/25/2005,9/29/2005,35,0,35
9/6/2005,9/6/2005,10/11/2005,35,0,35
9/7/2005,9/7/2005,10/12/2005,35,0,35
9/7/2005,9/7/2005,10/11/2005,34,0,34
9/8/2005,9/8/2005,10/12/2005,34,0,34
9/9/2005,9/9/2005,10/13/2005,34,0,34
9/9/2005,9/9/2005,10/13/2005,34,0,34
9/12/2005,9/12/2005,10/14/2005,32,0,32
9/13/2005,9/13/2005,10/17/2005,34,0,34
9/14/2005,9/14/2005,10/19/2005,35,0,35
9/14/2005,9/14/2005,10/17/2005,33,0,33
9/16/2005,9/16/2005,8/10/2005,-37,0,-37
8/10/2005,9/16/2005,9/12/2005,-4,37,33
8/10/2005,9/16/2005,9/12/2005,-4,37,33
9/23/2005,9/23/2005,10/27/2005,34,0,34
9/28/2005,9/28/2005,10/31/2005,33,0,33
10/7/2005,10/7/2005,11/9/2005,33,0,33
10/7/2005,10/7/2005,11/9/2005,33,0,33
10/7/2005,10/7/2005,11/10/2005,34,0,34
10/7/2005,10/7/2005,11/10/2005,34,0,34
10/10/2005,10/10/2005,11/14/2005,35,0,35
10/10/2005,10/10/2005,11/10/2005,31,0,31
10/11/2005,10/11/2005,11/15/2005,35,0,35
10/11/2005,10/11/2005,11/10/2005,30,0,30
10/11/2005,10/11/2005,11/10/2005,30,0,30
10/12/2005,10/12/2005,10/28/2005,16,0,16
10/12/2005,10/12/2005,11/17/2005,36,0,36
10/13/2005,10/13/2005,11/17/2005,35,0,35
10/17/2005,10/17/2005,1/18/2006,93,0,93
10/17/2005,10/17/2005,11/18/2005,32,0,32
9/12/2005,10/17/2005,10/11/2005,-6,35,29
10/18/2005,10/18/2005,11/17/2005,30,0,30
10/21/2005,10/21/2005,1/25/2006,96,0,96
10/25/2005,10/25/2005,11/29/2005,35,0,35
10/25/2005,10/25/2005,11/29/2005,35,0,35
10/26/2005,10/26/2005,11/29/2005,34,0,34
10/26/2005,10/26/2005,11/29/2005,34,0,34
7/21/2005,11/4/2005,8/22/2005,-74,106,32
8/22/2005,11/4/2005,9/21/2005,-44,74,30
9/21/2005,11/4/2005,10/21/2005,-14,44,30
11/7/2005,11/7/2005,12/8/2005,31,0,31
11/8/2005,11/8/2005,12/9/2005,31,0,31
11/8/2005,11/8/2005,12/9/2005,31,0,31
11/8/2005,11/8/2005,12/12/2005,34,0,34
11/8/2005,11/8/2005,12/12/2005,34,0,34
11/8/2005,11/8/2005,10/28/2005,-11,0,-11
11/8/2005,11/8/2005,11/7/2005,-1,0,-1
11/9/2005,11/9/2005,12/13/2005,34,0,34
11/9/2005,11/9/2005,11/14/2005,5,0,5
11/10/2005,11/10/2005,12/13/2005,33,0,33
11/10/2005,11/10/2005,12/14/2005,34,0,34
11/14/2005,11/14/2005,12/14/2005,30,0,30
11/15/2005,11/15/2005,12/15/2005,30,0,30
11/16/2005,11/16/2005,12/15/2005,29,0,29
11/16/2005,11/16/2005,12/16/2005,30,0,30
11/17/2005,11/17/2005,12/21/2005,34,0,34
11/25/2005,11/25/2005,12/30/2005,35,0,35
11/25/2005,11/25/2005,12/22/2005,27,0,27
11/25/2005,11/25/2005,12/22/2005,27,0,27
11/25/2005,11/25/2005,12/30/2005,35,0,35
11/28/2005,11/28/2005,12/30/2005,32,0,32
12/6/2005,12/6/2005,1/10/2006,35,0,35
11/17/2005,11/30/2005,11/28/2005,-2,13,11
11/25/2005,11/30/2005,12/2/2005,2,5,7
12/6/2005,12/6/2005,1/10/2006,35,0,35
12/7/2005,12/7/2005,1/10/2006,34,0,34
12/7/2005,12/7/2005,12/9/2005,2,0,2
12/8/2005,12/8/2005,1/5/2006,28,0,28
12/8/2005,12/8/2005,1/5/2006,28,0,28
12/8/2005,12/8/2005,12/28/2005,20,0,20
12/12/2005,12/12/2005,1/13/2006,32,0,32
12/13/2005,12/13/2005,1/16/2006,34,0,34
12/14/2005,12/14/2005,1/17/2006,34,0,34
12/8/2005,12/14/2005,12/16/2005,2,6,8
12/20/2005,12/20/2005,1/23/2006,34,0,34
12/20/2005,12/20/2005,1/23/2006,34,0,34
12/22/2005,12/22/2005,1/10/2006,19,0,19
12/28/2005,12/28/2005,1/31/2006,34,0,34
12/28/2005,12/28/2005,1/30/2006,33,0,33
1/4/2006,1/4/2006,2/6/2006,33,0,33
1/6/2006,1/6/2006,2/9/2006,34,0,34
1/6/2006,1/6/2006,1/25/2006,19,0,19
1/6/2006,1/6/2006,2/8/2006,33,0,33
1/9/2006,1/9/2006,2/9/2006,31,0,31
1/10/2006,1/10/2006,2/10/2006,31,0,31
1/10/2006,1/10/2006,2/13/2006,34,0,34
1/11/2006,1/11/2006,2/13/2006,33,0,33
1/11/2006,1/11/2006,1/3/2006,-8,0,-8
1/11/2006,1/11/2006,1/13/2006,2,0,2
1/12/2006,1/12/2006,2/15/2006,34,0,34
1/16/2006,1/16/2006,4/21/2006,95,0,95
1/13/2006,1/13/2006,4/18/2006,95,0,95
1/19/2006,1/19/2006,2/21/2006,33,0,33
1/19/2006,1/19/2006,2/20/2006,32,0,32
1/23/2006,1/23/2006,2/10/2006,18,0,18
1/25/2006,1/25/2006,3/1/2006,35,0,35
1/26/2006,1/26/2006,2/23/2006,28,0,28
1/26/2006,1/26/2006,2/23/2006,28,0,28
1/27/2006,1/27/2006,2/28/2006,32,0,32
2/2/2006,2/2/2006,3/6/2006,32,0,32
2/6/2006,2/6/2006,3/8/2006,30,0,30
2/8/2006,2/8/2006,2/28/2006,20,0,20
2/9/2006,2/9/2006,3/10/2006,29,0,29
2/9/2006,2/9/2006,3/13/2006,32,0,32
2/10/2006,2/10/2006,3/14/2006,32,0,32
2/13/2006,2/13/2006,3/15/2006,30,0,30
2/14/2006,2/14/2006,3/16/2006,30,0,30
2/16/2006,2/16/2006,3/20/2006,32,0,32
2/16/2006,2/16/2006,3/20/2006,32,0,32
2/20/2006,2/20/2006,3/21/2006,29,0,29
2/21/2006,2/21/2006,3/30/2006,37,0,37
2/24/2006,2/24/2006,3/31/2006,35,0,35
2/24/2006,2/24/2006,3/10/2006,14,0,14
2/27/2006,2/27/2006,3/29/2006,30,0,30
3/2/2006,3/2/2006,4/3/2006,32,0,32
3/2/2006,3/2/2006,4/3/2006,32,0,32
3/6/2006,3/6/2006,4/10/2006,35,0,35
3/8/2006,3/8/2006,3/27/2006,19,0,19
3/10/2006,3/10/2006,4/18/2006,39,0,39
3/14/2006,3/14/2006,4/18/2006,35,0,35
3/14/2006,3/14/2006,4/18/2006,35,0,35
3/16/2006,3/16/2006,4/20/2006,35,0,35
3/17/2006,3/17/2006,3/6/2006,-11,0,-11
3/17/2006,3/17/2006,4/21/2006,35,0,35
3/17/2006,3/17/2006,4/3/2006,17,0,17
3/23/2006,3/23/2006,4/10/2006,18,0,18
3/29/2006,3/29/2006,4/28/2006,30,0,30
3/30/2006,3/30/2006,5/3/2006,34,0,34
4/6/2006,4/6/2006,5/10/2006,34,0,34
4/6/2006,4/6/2006,4/25/2006,19,0,19
4/7/2006,4/7/2006,5/11/2006,34,0,34
4/10/2006,4/10/2006,5/12/2006,32,0,32
4/12/2006,4/12/2006,5/16/2006,34,0,34
4/12/2006,4/12/2006,5/17/2006,35,0,35
4/12/2006,4/12/2006,7/18/2006,97,0,97
4/13/2006,4/13/2006,4/25/2006,12,0,12
4/13/2006,4/13/2006,5/15/2006,32,0,32
4/18/2006,4/18/2006,5/18/2006,30,0,30
4/18/2006,4/18/2006,5/2/2006,14,0,14
4/19/2006,4/19/2006,7/20/2006,92,0,92
4/21/2006,4/21/2006,7/25/2006,95,0,95
4/26/2006,4/26/2006,5/30/2006,34,0,34
4/28/2006,4/28/2006,5/17/2006,19,0,19
4/28/2006,4/28/2006,6/2/2006,35,0,35
4/28/2006,4/28/2006,6/2/2006,35,0,35
5/2/2006,5/2/2006,6/2/2006,31,0,31
5/5/2006,5/5/2006,6/9/2006,35,0,35
5/9/2006,5/9/2006,6/12/2006,34,0,34
5/10/2006,5/10/2006,6/13/2006,34,0,34
5/12/2006,5/12/2006,6/15/2006,34,0,34
5/11/2006,5/11/2006,6/14/2006,34,0,34
5/15/2006,5/15/2006,6/15/2006,31,0,31
5/16/2006,5/16/2006,6/15/2006,30,0,30
5/16/2006,5/16/2006,6/20/2006,35,0,35
5/18/2006,5/18/2006,6/21/2006,34,0,34
5/23/2006,5/23/2006,6/27/2006,35,0,35
5/24/2006,5/24/2006,6/12/2006,19,0,19
5/24/2006,5/24/2006,6/29/2006,36,0,36
5/30/2006,5/30/2006,7/4/2006,35,0,35
6/1/2006,6/1/2006,7/6/2006,35,0,35
6/1/2006,6/1/2006,7/6/2006,35,0,35
6/8/2006,6/8/2006,6/26/2006,18,0,18
6/8/2006,6/8/2006,7/11/2006,33,0,33
6/9/2006,6/9/2006,7/12/2006,33,0,33
6/12/2006,6/12/2006,7/13/2006,31,0,31
6/13/2006,6/13/2006,7/17/2006,34,0,34
6/14/2006,6/14/2006,7/18/2006,34,0,34
6/16/2006,6/16/2006,7/19/2006,33,0,33
6/19/2006,6/19/2006,7/21/2006,32,0,32
6/22/2006,6/22/2006,7/10/2006,18,0,18
6/26/2006,6/26/2006,7/25/2006,29,0,29
6/27/2006,6/27/2006,7/28/2006,31,0,31
6/27/2006,6/27/2006,7/28/2006,31,0,31
6/28/2006,6/28/2006,7/31/2006,33,0,33
7/3/2006,7/3/2006,8/1/2006,29,0,29
7/6/2006,7/6/2006,8/9/2006,34,0,34
7/7/2006,7/7/2006,8/9/2006,33,0,33
7/11/2006,7/11/2006,8/11/2006,31,0,31
7/11/2006,7/11/2006,8/10/2006,30,0,30
7/11/2006,7/11/2006,8/16/2006,36,0,36
7/12/2006,7/12/2006,8/16/2006,35,0,35
7/13/2006,7/13/2006,8/18/2006,36,0,36
7/13/2006,7/13/2006,10/17/2006,96,0,96
7/17/2006,7/17/2006,8/17/2006,31,0,31
7/18/2006,7/18/2006,10/18/2006,92,0,92
7/19/2006,7/19/2006,8/21/2006,33,0,33
7/21/2006,7/21/2006,10/25/2006,96,0,96
7/21/2006,7/21/2006,8/10/2006,20,0,20
7/21/2006,7/21/2006,8/25/2006,35,0,35
7/21/2006,7/21/2006,8/25/2006,35,0,35
7/26/2006,7/26/2006,8/30/2006,35,0,35
7/26/2006,7/26/2006,8/30/2006,35,0,35
7/27/2006,7/27/2006,8/31/2006,35,0,35
7/28/2006,7/28/2006,9/1/2006,35,0,35
8/2/2006,8/2/2006,9/7/2006,36,0,36
8/7/2006,8/7/2006,9/11/2006,35,0,35
8/7/2006,8/7/2006,9/11/2006,35,0,35
8/8/2006,8/8/2006,8/25/2006,17,0,17
8/9/2006,8/9/2006,9/13/2006,35,0,35
8/10/2006,8/10/2006,9/14/2006,35,0,35
3/21/2006,8/10/2006,4/28/2006,-104,142,38
4/24/2006,8/10/2006,5/31/2006,-71,108,37
5/29/2006,8/10/2006,6/30/2006,-41,73,32
8/11/2006,8/11/2006,9/15/2006,35,0,35
8/17/2006,8/17/2006,9/21/2006,35,0,35
8/23/2006,8/23/2006,9/11/2006,19,0,19
8/23/2006,8/23/2006,9/25/2006,33,0,33
8/23/2006,8/23/2006,9/25/2006,33,0,33
8/28/2006,8/28/2006,9/29/2006,32,0,32
8/29/2006,8/29/2006,9/29/2006,31,0,31
8/29/2006,8/29/2006,9/29/2006,31,0,31
9/5/2006,9/5/2006,10/4/2006,29,0,29
9/5/2006,9/5/2006,10/4/2006,29,0,29
9/6/2006,9/6/2006,10/9/2006,33,0,33
9/7/2006,9/7/2006,10/10/2006,33,0,33
9/7/2006,9/7/2006,10/11/2006,34,0,34
9/8/2006,9/8/2006,10/11/2006,33,0,33
9/11/2006,9/11/2006,10/12/2006,31,0,31
9/11/2006,9/11/2006,8/21/2006,-21,0,-21
9/11/2006,9/11/2006,6/20/2006,-83,0,-83
9/11/2006,9/11/2006,7/21/2006,-52,0,-52
9/12/2006,9/12/2006,10/13/2006,31,0,31
9/13/2006,9/13/2006,10/17/2006,34,0,34
9/13/2006,9/13/2006,10/16/2006,33,0,33
9/14/2006,9/14/2006,10/18/2006,34,0,34
9/18/2006,9/18/2006,10/19/2006,31,0,31
9/19/2006,9/19/2006,10/23/2006,34,0,34
9/21/2006,9/21/2006,10/25/2006,34,0,34
9/21/2006,9/21/2006,8/7/2006,-45,0,-45
9/21/2006,9/21/2006,9/8/2006,-13,0,-13
9/21/2006,9/21/2006,9/29/2006,8,0,8
9/27/2006,9/27/2006,10/31/2006,34,0,34
9/27/2006,9/27/2006,10/27/2006,30,0,30
9/27/2006,9/27/2006,10/27/2006,30,0,30
9/27/2006,9/27/2006,10/31/2006,34,0,34
10/2/2006,10/2/2006,11/2/2006,31,0,31
10/2/2006,10/2/2006,11/7/2006,36,0,36
10/5/2006,10/5/2006,11/8/2006,34,0,34
10/6/2006,10/6/2006,10/25/2006,19,0,19
10/6/2006,10/6/2006,11/10/2006,35,0,35
10/9/2006,10/9/2006,11/10/2006,32,0,32
10/10/2006,10/10/2006,11/14/2006,35,0,35
10/10/2006,10/10/2006,11/8/2006,29,0,29
10/10/2006,10/10/2006,10/12/2006,2,0,2
10/11/2006,10/11/2006,11/17/2006,37,0,37
10/12/2006,10/12/2006,11/15/2006,34,0,34
10/13/2006,10/13/2006,11/15/2006,33,0,33
10/13/2006,10/13/2006,11/15/2006,33,0,33
10/13/2006,10/13/2006,1/17/2007,96,0,96
10/16/2006,10/16/2006,11/20/2006,35,0,35
10/17/2006,10/17/2006,11/21/2006,35,0,35
10/19/2006,10/19/2006,11/21/2006,33,0,33
10/23/2006,10/23/2006,1/25/2007,94,0,94
10/23/2006,10/23/2006,11/10/2006,18,0,18
10/23/2006,10/23/2006,11/27/2006,35,0,35
10/23/2006,10/23/2006,11/27/2006,35,0,35
10/25/2006,10/25/2006,11/29/2006,35,0,35
10/25/2006,10/25/2006,11/29/2006,35,0,35
10/27/2006,10/27/2006,1/15/2007,80,0,80
10/27/2006,10/27/2006,11/30/2006,34,0,34
10/30/2006,10/30/2006,12/4/2006,35,0,35
11/3/2006,11/3/2006,12/5/2006,32,0,32
11/3/2006,11/3/2006,12/5/2006,32,0,32
11/6/2006,11/6/2006,12/8/2006,32,0,32
11/6/2006,11/6/2006,12/11/2006,35,0,35
11/8/2006,11/8/2006,12/11/2006,33,0,33
11/13/2006,11/13/2006,12/15/2006,32,0,32
11/13/2006,11/13/2006,12/13/2006,30,0,30
11/14/2006,11/14/2006,12/15/2006,31,0,31
11/14/2006,11/14/2006,12/15/2006,31,0,31
11/15/2006,11/15/2006,12/18/2006,33,0,33
11/16/2006,11/16/2006,12/19/2006,33,0,33
11/16/2006,11/16/2006,10/11/2006,-36,0,-36
11/16/2006,11/16/2006,11/13/2006,-3,0,-3
11/20/2006,11/20/2006,2/20/2007,92,0,92
11/20/2006,11/20/2006,12/20/2006,30,0,30
11/24/2006,11/24/2006,12/22/2006,28,0,28
11/27/2006,11/27/2006,12/29/2006,32,0,32
11/28/2006,11/28/2006,12/29/2006,31,0,31
11/29/2006,11/29/2006,12/29/2006,30,0,30
11/30/2006,11/30/2006,1/8/2007,39,0,39
12/4/2006,12/4/2006,1/5/2007,32,0,32
12/6/2006,12/6/2006,1/9/2007,34,0,34
12/7/2006,12/7/2006,1/10/2007,34,0,34
12/7/2006,12/7/2006,12/27/2006,20,0,20
12/7/2006,12/7/2006,12/29/2006,22,0,22
12/7/2006,12/7/2006,1/12/2007,36,0,36
12/8/2006,12/8/2006,1/10/2007,33,0,33
12/11/2006,12/11/2006,1/11/2007,31,0,31
12/12/2006,12/12/2006,1/12/2007,31,0,31
12/13/2006,12/13/2006,1/17/2007,35,0,35
12/13/2006,12/13/2006,1/15/2007,33,0,33
12/14/2006,12/14/2006,1/17/2007,34,0,34
12/18/2006,12/18/2006,1/19/2007,32,0,32
12/19/2006,12/19/2006,1/22/2007,34,0,34
12/20/2006,12/20/2006,1/30/2007,41,0,41
12/27/2006,12/27/2006,1/31/2007,35,0,35
12/27/2006,12/27/2006,1/31/2007,35,0,35
12/27/2006,12/27/2006,1/30/2007,34,0,34
12/27/2006,12/27/2006,1/12/2007,16,0,16
12/28/2006,12/28/2006,1/30/2007,33,0,33
1/4/2007,1/4/2007,2/1/2007,28,0,28
1/5/2007,1/5/2007,2/7/2007,33,0,33
1/5/2007,1/5/2007,2/8/2007,34,0,34
1/8/2007,1/8/2007,2/9/2007,32,0,32
12/29/2006,1/9/2007,12/12/2006,-28,11,-17
1/9/2007,1/9/2007,2/12/2007,34,0,34
1/10/2007,1/10/2007,2/13/2007,34,0,34
1/11/2007,1/11/2007,4/13/2007,92,0,92
1/15/2007,1/15/2007,4/17/2007,92,0,92
1/15/2007,1/15/2007,2/15/2007,31,0,31
1/15/2007,1/15/2007,2/16/2007,32,0,32
1/17/2007,1/17/2007,2/20/2007,34,0,34
1/17/2007,1/17/2007,2/20/2007,34,0,34
1/18/2007,1/18/2007,2/21/2007,34,0,34
1/23/2007,1/23/2007,2/12/2007,20,0,20
1/26/2007,1/26/2007,2/27/2007,32,0,32
1/29/2007,1/29/2007,2/28/2007,30,0,30
1/26/2007,1/26/2007,2/26/2007,31,0,31
2/6/2007,2/6/2007,3/8/2007,30,0,30
2/7/2007,2/7/2007,3/9/2007,30,0,30
2/8/2007,2/8/2007,2/26/2007,18,0,18
2/8/2007,2/8/2007,9/18/2006,-143,0,-143
2/8/2007,2/8/2007,10/17/2006,-114,0,-114
2/8/2007,2/8/2007,11/17/2006,-83,0,-83
2/8/2007,2/8/2007,1/17/2007,-22,0,-22
2/9/2007,2/9/2007,3/12/2007,31,0,31
3/6/2007,3/6/2007,3/30/2007,24,0,24
2/13/2007,2/13/2007,3/16/2007,31,0,31
2/14/2007,2/14/2007,3/15/2007,29,0,29
1/15/2007,2/15/2007,2/19/2007,4,31,35
2/15/2007,2/15/2007,3/19/2007,32,0,32
2/16/2007,2/16/2007,5/24/2007,97,0,97
2/19/2007,2/19/2007,3/21/2007,30,0,30
2/22/2007,2/22/2007,3/26/2007,32,0,32
2/22/2007,2/22/2007,3/26/2007,32,0,32
2/22/2007,2/22/2007,3/12/2007,18,0,18
2/26/2007,2/26/2007,3/30/2007,32,0,32
3/2/2007,3/2/2007,4/3/2007,32,0,32
3/6/2007,3/6/2007,3/13/2007,7,0,7
3/6/2007,3/6/2007,4/10/2007,35,0,35
3/7/2007,3/7/2007,4/12/2007,36,0,36
3/8/2007,3/8/2007,3/26/2007,18,0,18
3/8/2007,3/8/2007,4/13/2007,36,0,36
3/9/2007,3/9/2007,4/13/2007,35,0,35
3/9/2007,3/9/2007,4/16/2007,38,0,38
3/13/2007,3/13/2007,4/16/2007,34,0,34
3/13/2007,3/13/2007,4/17/2007,35,0,35
3/14/2007,3/14/2007,4/10/2007,27,0,27
3/14/2007,3/14/2007,4/19/2007,36,0,36
3/16/2007,3/16/2007,4/23/2007,38,0,38
3/19/2007,3/19/2007,4/23/2007,35,0,35
3/22/2007,3/22/2007,4/10/2007,19,0,19
3/22/2007,3/22/2007,4/27/2007,36,0,36
3/28/2007,3/28/2007,4/13/2007,16,0,16
4/4/2007,4/4/2007,4/27/2007,23,0,23
4/5/2007,4/4/2007,5/10/2007,36,-1,35
4/5/2007,4/5/2007,4/25/2007,20,0,20
4/6/2007,4/6/2007,1/16/2007,-80,0,-80
4/6/2007,4/6/2007,3/15/2007,-22,0,-22
4/10/2007,4/10/2007,5/11/2007,31,0,31
4/11/2007,4/11/2007,7/13/2007,93,0,93
4/11/2007,4/11/2007,5/14/2007,33,0,33
4/12/2007,4/12/2007,5/15/2007,33,0,33
4/13/2007,4/13/2007,5/16/2007,33,0,33
4/17/2007,4/17/2007,5/16/2007,29,0,29
4/17/2007,4/17/2007,5/16/2007,29,0,29
4/17/2007,4/17/2007,5/18/2007,31,0,31
4/19/2007,4/19/2007,5/24/2007,35,0,35
4/19/2007,4/19/2007,4/17/2007,-2,0,-2
4/19/2007,4/19/2007,5/21/2007,32,0,32
4/23/2007,4/23/2007,5/10/2007,17,0,17
4/25/2007,4/25/2007,5/31/2007,36,0,36
4/25/2007,4/25/2007,5/7/2007,12,0,12
4/25/2007,4/25/2007,5/31/2007,36,0,36
4/25/2007,4/25/2007,5/16/2007,21,0,21
4/25/2007,4/25/2007,5/16/2007,21,0,21
5/4/2007,5/4/2007,5/25/2007,21,0,21
5/4/2007,5/4/2007,5/25/2007,21,0,21
5/7/2007,5/7/2007,6/11/2007,35,0,35
5/7/2007,5/7/2007,6/8/2007,32,0,32
5/9/2007,5/9/2007,6/11/2007,33,0,33
5/9/2007,5/9/2007,1/22/2007,-107,0,-107
5/9/2007,5/9/2007,2/21/2007,-77,0,-77
5/9/2007,5/9/2007,4/23/2007,-16,0,-16
5/9/2007,5/9/2007,5/21/2007,12,0,12
5/10/2007,5/10/2007,6/12/2007,33,0,33
5/11/2007,5/11/2007,6/13/2007,33,0,33
5/14/2007,5/14/2007,5/31/2007,17,0,17
5/14/2007,5/14/2007,5/31/2007,17,0,17
5/14/2007,5/14/2007,6/8/2007,25,0,25
5/14/2007,5/14/2007,6/20/2007,37,0,37
5/14/2007,5/14/2007,6/13/2007,30,0,30
5/15/2007,5/15/2007,6/18/2007,34,0,34
5/15/2007,5/15/2007,6/15/2007,31,0,31
5/16/2007,5/16/2007,6/21/2007,36,0,36
5/23/2007,5/23/2007,6/11/2007,19,0,19
5/23/2007,5/23/2007,6/11/2007,19,0,19
5/24/2007,5/24/2007,5/21/2007,-3,0,-3
5/24/2007,5/24/2007,6/19/2007,26,0,26
5/25/2007,5/25/2007,6/28/2007,34,0,34
5/29/2007,5/29/2007,6/20/2007,22,0,22
5/29/2007,5/29/2007,6/28/2007,30,0,30
6/6/2007,6/6/2007,6/20/2007,14,0,14
6/6/2007,6/6/2007,7/9/2007,33,0,33
6/6/2007,6/6/2007,6/29/2007,23,0,23
6/6/2007,6/6/2007,6/25/2007,19,0,19
6/7/2007,6/7/2007,7/10/2007,33,0,33
6/8/2007,6/8/2007,7/11/2007,33,0,33
6/11/2007,6/11/2007,7/12/2007,31,0,31
6/11/2007,6/11/2007,7/11/2007,30,0,30
6/14/2007,6/14/2007,7/17/2007,33,0,33
6/15/2007,6/15/2007,7/17/2007,32,0,32
6/19/2007,6/19/2007,7/23/2007,34,0,34
6/19/2007,6/19/2007,9/20/2007,93,0,93
6/19/2007,6/19/2007,7/19/2007,30,0,30
6/19/2007,6/19/2007,7/23/2007,34,0,34
6/19/2007,6/19/2007,7/9/2007,20,0,20
6/19/2007,6/19/2007,7/9/2007,20,0,20
6/26/2007,6/26/2007,7/31/2007,35,0,35
6/26/2007,6/26/2007,7/30/2007,34,0,34
6/26/2007,6/26/2007,7/31/2007,35,0,35
6/27/2007,6/27/2007,7/31/2007,34,0,34
6/27/2007,6/27/2007,7/12/2007,15,0,15
7/2/2007,7/2/2007,8/1/2007,30,0,30
7/5/2007,7/5/2007,6/20/2007,-15,0,-15
7/5/2007,7/5/2007,7/20/2007,15,0,15
7/5/2007,7/5/2007,7/18/2007,13,0,13
7/6/2007,7/6/2007,7/25/2007,19,0,19
7/6/2007,7/6/2007,8/9/2007,34,0,34
7/9/2007,7/9/2007,8/10/2007,32,0,32
7/10/2007,7/10/2007,8/13/2007,34,0,34
7/11/2007,7/11/2007,10/15/2007,96,0,96
7/12/2007,7/12/2007,8/16/2007,35,0,35
7/12/2007,7/12/2007,8/16/2007,35,0,35
7/13/2007,7/13/2007,8/20/2007,38,0,38
7/13/2007,7/13/2007,8/17/2007,35,0,35
7/13/2007,7/13/2007,10/17/2007,96,0,96
7/16/2007,7/16/2007,7/31/2007,15,0,15
7/16/2007,7/16/2007,8/17/2007,32,0,32
7/16/2007,7/16/2007,8/17/2007,32,0,32
7/17/2007,7/17/2007,8/21/2007,35,0,35
7/18/2007,7/18/2007,8/20/2007,33,0,33
7/19/2007,7/19/2007,8/21/2007,33,0,33
7/23/2007,7/23/2007,8/10/2007,18,0,18
7/27/2007,7/27/2007,8/31/2007,35,0,35
7/27/2007,7/27/2007,8/8/2007,12,0,12
7/27/2007,7/27/2007,8/8/2007,12,0,12
7/27/2007,7/27/2007,8/30/2007,34,0,34
7/30/2007,7/30/2007,9/3/2007,35,0,35
7/30/2007,7/30/2007,11/2/2007,95,0,95
8/6/2007,8/6/2007,8/30/2007,24,0,24
8/8/2007,8/8/2007,8/28/2007,20,0,20
8/8/2007,8/8/2007,8/28/2007,20,0,20
8/8/2007,8/8/2007,9/12/2007,35,0,35
8/8/2007,8/8/2007,11/13/2007,97,0,97
8/9/2007,8/9/2007,9/13/2007,35,0,35
8/13/2007,8/13/2007,9/17/2007,35,0,35
8/14/2007,8/14/2007,9/17/2007,34,0,34
8/14/2007,8/14/2007,9/10/2007,27,0,27
8/16/2007,8/16/2007,9/20/2007,35,0,35
8/17/2007,8/17/2007,9/20/2007,34,0,34
8/17/2007,8/17/2007,9/21/2007,35,0,35
8/23/2007,8/23/2007,9/25/2007,33,0,33
8/23/2007,8/23/2007,9/25/2007,33,0,33
8/28/2007,8/28/2007,9/10/2007,13,0,13
8/29/2007,8/29/2007,9/28/2007,30,0,30
8/29/2007,8/29/2007,9/7/2007,9,0,9
9/5/2007,9/5/2007,9/14/2007,9,0,9
8/30/2007,8/30/2007,9/7/2007,8,0,8
9/6/2007,9/6/2007,9/19/2007,13,0,13
9/6/2007,9/6/2007,9/14/2007,8,0,8
9/6/2007,9/6/2007,10/9/2007,33,0,33
9/7/2007,9/7/2007,10/9/2007,32,0,32
9/10/2007,9/10/2007,10/10/2007,30,0,30
9/12/2007,9/12/2007,9/21/2007,9,0,9
9/13/2007,9/13/2007,10/17/2007,34,0,34
9/13/2007,9/13/2007,9/21/2007,8,0,8
9/14/2007,9/14/2007,10/17/2007,33,0,33
9/17/2007,9/17/2007,9/27/2007,10,0,10
9/18/2007,9/18/2007,10/18/2007,30,0,30
9/18/2007,9/18/2007,12/20/2007,93,0,93
9/18/2007,9/18/2007,10/22/2007,34,0,34
9/20/2007,9/20/2007,9/28/2007,8,0,8
9/21/2007,9/21/2007,10/10/2007,19,0,19
9/25/2007,9/25/2007,10/5/2007,10,0,10
9/25/2007,9/25/2007,10/5/2007,10,0,10
9/26/2007,9/26/2007,10/31/2007,35,0,35
9/28/2007,9/28/2007,10/5/2007,7,0,7
10/1/2007,10/1/2007,11/2/2007,32,0,32
10/3/2007,10/3/2007,10/16/2007,13,0,13
10/3/2007,10/3/2007,10/16/2007,13,0,13
10/4/2007,10/4/2007,10/12/2007,8,0,8
10/5/2007,10/5/2007,11/9/2007,35,0,35
10/5/2007,10/5/2007,10/25/2007,20,0,20
10/5/2007,10/5/2007,10/25/2007,20,0,20
10/5/2007,10/5/2007,11/12/2007,38,0,38
10/8/2007,10/8/2007,11/13/2007,36,0,36
10/10/2007,10/10/2007,11/14/2007,35,0,35
10/10/2007,10/10/2007,11/9/2007,30,0,30
10/11/2007,10/11/2007,1/14/2008,95,0,95
10/11/2007,10/11/2007,10/19/2007,8,0,8
10/12/2007,10/12/2007,10/25/2007,13,0,13
10/12/2007,10/12/2007,10/22/2007,10,0,10
10/15/2007,10/15/2007,11/15/2007,31,0,31
10/15/2007,10/15/2007,11/19/2007,35,0,35
10/16/2007,10/16/2007,11/21/2007,36,0,36
10/17/2007,10/17/2007,11/21/2007,35,0,35
10/18/2007,10/18/2007,10/26/2007,8,0,8
10/23/2007,10/23/2007,11/8/2007,16,0,16
10/23/2007,10/23/2007,11/13/2007,21,0,21
10/25/2007,10/25/2007,11/5/2007,11,0,11
10/29/2007,10/29/2007,1/31/2008,94,0,94
10/29/2007,10/29/2007,11/30/2007,32,0,32
10/30/2007,10/30/2007,2/1/2008,94,0,94
10/30/2007,10/30/2007,12/4/2007,35,0,35
11/2/2007,11/2/2007,11/9/2007,7,0,7
11/6/2007,11/6/2007,11/19/2007,13,0,13
11/7/2007,11/7/2007,12/10/2007,33,0,33
11/7/2007,11/7/2007,12/10/2007,33,0,33
11/8/2007,11/8/2007,11/19/2007,11,0,11
11/8/2007,11/8/2007,12/7/2007,29,0,29
11/8/2007,11/8/2007,11/16/2007,8,0,8
11/9/2007,11/9/2007,11/26/2007,17,0,17
11/9/2007,11/9/2007,2/12/2008,95,0,95
11/12/2007,11/12/2007,2/13/2008,93,0,93
11/12/2007,11/12/2007,10/22/2007,-21,0,-21
11/12/2007,11/12/2007,11/15/2007,3,0,3
11/14/2007,11/14/2007,12/17/2007,33,0,33
11/15/2007,11/15/2007,2/15/2008,92,0,92
11/15/2007,11/15/2007,11/28/2007,13,0,13
11/15/2007,11/15/2007,12/17/2007,32,0,32
11/15/2007,11/15/2007,11/28/2007,13,0,13
11/15/2007,11/15/2007,11/26/2007,11,0,11
11/15/2007,11/15/2007,2/18/2008,95,0,95
11/15/2007,11/15/2007,12/18/2007,33,0,33
11/19/2007,11/19/2007,12/21/2007,32,0,32
11/19/2007,11/19/2007,12/21/2007,32,0,32
11/21/2007,11/21/2007,12/10/2007,19,0,19
11/21/2007,11/21/2007,12/10/2007,19,0,19
11/23/2007,11/23/2007,11/30/2007,7,0,7
11/26/2007,11/26/2007,12/7/2007,11,0,11
11/28/2007,11/28/2007,12/31/2007,33,0,33
11/28/2007,11/28/2007,12/20/2007,22,0,22
11/30/2007,11/30/2007,1/4/2008,35,0,35
12/3/2007,12/3/2007,12/7/2007,4,0,4
12/5/2007,12/5/2007,12/17/2007,12,0,12
12/5/2007,12/5/2007,1/9/2008,35,0,35
12/6/2007,12/6/2007,12/17/2007,11,0,11
12/6/2007,12/6/2007,1/10/2008,35,0,35
12/6/2007,12/6/2007,1/10/2008,35,0,35
12/6/2007,12/6/2007,1/11/2008,36,0,36
12/6/2007,12/6/2007,1/9/2008,34,0,34
12/10/2007,12/10/2007,1/14/2008,35,0,35
12/13/2007,12/13/2007,1/18/2008,36,0,36
12/13/2007,12/13/2007,12/21/2007,8,0,8
12/13/2007,12/13/2007,1/17/2008,35,0,35
12/14/2007,12/14/2007,1/17/2008,34,0,34
12/14/2007,12/14/2007,1/15/2008,32,0,32
12/14/2007,12/14/2007,1/16/2008,33,0,33
12/19/2007,12/19/2007,1/22/2008,34,0,34
12/19/2007,12/19/2007,1/22/2008,34,0,34
12/19/2007,12/19/2007,1/21/2008,33,0,33
12/27/2007,12/27/2007,1/31/2008,35,0,35
12/27/2007,12/27/2007,1/11/2008,15,0,15
12/28/2007,12/28/2007,1/4/2008,7,0,7
1/7/2008,1/7/2008,2/8/2008,32,0,32
1/7/2008,1/7/2008,1/17/2008,10,0,10
1/7/2008,1/7/2008,2/5/2008,29,0,29
1/8/2008,1/8/2008,1/25/2008,17,0,17
1/8/2008,1/8/2008,2/11/2008,34,0,34
1/8/2008,1/8/2008,2/11/2008,34,0,34
1/9/2008,1/9/2008,2/12/2008,34,0,34
1/9/2008,1/9/2008,2/7/2008,29,0,29
1/10/2008,1/10/2008,2/13/2008,34,0,34
1/10/2008,1/10/2008,1/18/2008,8,0,8
1/10/2008,1/10/2008,4/14/2008,95,0,95
1/11/2008,1/11/2008,2/15/2008,35,0,35
1/11/2008,1/11/2008,2/13/2008,33,0,33
1/15/2008,1/15/2008,1/25/2008,10,0,10
1/15/2008,1/15/2008,2/18/2008,34,0,34
1/15/2008,1/15/2008,2/19/2008,35,0,35
1/15/2008,1/15/2008,2/19/2008,35,0,35
1/17/2008,1/17/2008,2/20/2008,34,0,34
1/18/2008,1/18/2008,2/21/2008,34,0,34
1/23/2008,1/23/2008,2/5/2008,13,0,13
1/29/2008,1/29/2008,1/30/2008,1,0,1
1/29/2008,1/29/2008,2/28/2008,30,0,30
1/29/2008,1/29/2008,2/28/2008,30,0,30
1/29/2008,1/29/2008,2/28/2008,30,0,30
1/29/2008,1/29/2008,2/28/2008,30,0,30
1/30/2008,1/30/2008,3/5/2008,35,0,35
2/1/2008,2/1/2008,2/19/2008,18,0,18
2/1/2008,2/1/2008,3/7/2008,35,0,35
2/6/2008,2/6/2008,3/10/2008,33,0,33
2/7/2008,2/7/2008,2/15/2008,8,0,8
2/11/2008,2/11/2008,3/13/2008,31,0,31
2/11/2008,2/11/2008,3/13/2008,31,0,31
2/12/2008,2/12/2008,3/14/2008,31,0,31
2/13/2008,2/13/2008,3/17/2008,33,0,33
2/14/2008,2/14/2008,2/22/2008,8,0,8
2/15/2008,2/15/2008,3/17/2008,31,0,31
2/15/2008,2/15/2008,2/27/2008,12,0,12
2/15/2008,2/15/2008,3/14/2008,28,0,28
2/18/2008,2/18/2008,3/20/2008,31,0,31
2/19/2008,2/19/2008,3/25/2008,35,0,35
2/20/2008,2/20/2008,3/25/2008,34,0,34
2/21/2008,2/21/2008,2/29/2008,8,0,8
2/21/2008,2/21/2008,3/10/2008,18,0,18
2/21/2008,2/21/2008,3/10/2008,18,0,18
2/25/2008,2/25/2008,3/7/2008,11,0,11
3/3/2008,3/3/2008,4/3/2008,31,0,31
3/5/2008,3/5/2008,3/14/2008,9,0,9
3/5/2008,3/5/2008,4/8/2008,34,0,34
3/6/2008,3/6/2008,3/31/2008,25,0,25
3/6/2008,3/6/2008,4/11/2008,36,0,36
3/6/2008,3/6/2008,3/25/2008,19,0,19
3/6/2008,3/6/2008,3/25/2008,19,0,19
3/6/2008,3/6/2008,4/8/2008,33,0,33
3/6/2008,3/6/2008,3/14/2008,8,0,8
3/7/2008,3/7/2008,4/9/2008,33,0,33
3/12/2008,3/12/2008,3/26/2008,14,0,14
3/13/2008,3/13/2008,4/17/2008,35,0,35
3/13/2008,3/13/2008,3/25/2008,12,0,12
3/13/2008,3/13/2008,4/15/2008,33,0,33
3/13/2008,3/13/2008,4/16/2008,34,0,34
3/14/2008,3/14/2008,4/16/2008,33,0,33
3/14/2008,3/14/2008,4/18/2008,35,0,35
3/18/2008,3/18/2008,4/18/2008,31,0,31
3/19/2008,3/19/2008,4/21/2008,33,0,33
3/19/2008,3/19/2008,4/10/2008,22,0,22
3/19/2008,3/19/2008,4/21/2008,33,0,33
3/26/2008,3/26/2008,4/29/2008,34,0,34
3/27/2008,3/27/2008,4/4/2008,8,0,8
4/1/2008,4/1/2008,5/7/2008,36,0,36
4/3/2008,4/3/2008,4/11/2008,8,0,8
4/4/2008,4/4/2008,5/7/2008,33,0,33
4/8/2008,4/8/2008,5/15/2008,37,0,37
4/4/2008,4/7/2008,4/17/2008,10,3,13
4/8/2008,4/8/2008,4/25/2008,17,0,17
4/8/2008,4/8/2008,5/13/2008,35,0,35
4/9/2008,4/9/2008,5/16/2008,37,0,37
4/10/2008,4/10/2008,7/15/2008,96,0,96
4/10/2008,4/10/2008,5/14/2008,34,0,34
4/14/2008,4/14/2008,5/21/2008,37,0,37
4/14/2008,4/14/2008,5/19/2008,35,0,35
4/15/2008,4/15/2008,5/19/2008,34,0,34
4/15/2008,4/15/2008,4/24/2008,9,0,9
4/15/2008,4/15/2008,4/24/2008,9,0,9
4/16/2008,4/16/2008,5/23/2008,37,0,37
4/17/2008,4/17/2008,4/25/2008,8,0,8
4/17/2008,4/17/2008,5/21/2008,34,0,34
4/22/2008,4/22/2008,5/7/2008,15,0,15
4/22/2008,4/22/2008,5/7/2008,15,0,15
4/24/2008,4/24/2008,5/6/2008,12,0,12
4/25/2008,4/25/2008,5/30/2008,35,0,35
4/23/2008,4/23/2008,5/13/2008,20,0,20
5/2/2008,5/2/2008,5/13/2008,11,0,11
5/5/2008,5/5/2008,6/4/2008,30,0,30
5/5/2008,5/5/2008,5/19/2008,14,0,14
5/5/2008,5/5/2008,5/19/2008,14,0,14
5/5/2008,5/5/2008,6/5/2008,31,0,31
5/7/2008,5/7/2008,6/9/2008,33,0,33
5/9/2008,5/9/2008,5/27/2008,18,0,18
5/9/2008,5/9/2008,6/6/2008,28,0,28
5/9/2008,5/9/2008,6/13/2008,35,0,35
5/13/2008,5/13/2008,6/11/2008,29,0,29
5/13/2008,5/13/2008,6/12/2008,30,0,30
5/14/2008,5/14/2008,6/13/2008,30,0,30
5/15/2008,5/15/2008,5/27/2008,12,0,12
5/15/2008,5/15/2008,6/17/2008,33,0,33
5/15/2008,5/15/2008,6/16/2008,32,0,32
5/16/2008,5/16/2008,5/23/2008,7,0,7
5/15/2008,5/15/2008,6/12/2008,28,0,28
5/19/2008,5/19/2008,6/24/2008,36,0,36
5/19/2008,5/19/2008,6/23/2008,35,0,35
5/21/2008,5/21/2008,6/19/2008,29,0,29
5/23/2008,5/23/2008,6/5/2008,13,0,13
5/28/2008,5/28/2008,6/30/2008,33,0,33
5/28/2008,5/28/2008,6/27/2008,30,0,30
6/3/2008,6/3/2008,7/7/2008,34,0,34
6/4/2008,6/4/2008,7/7/2008,33,0,33
6/4/2008,6/4/2008,7/7/2008,33,0,33
6/5/2008,6/5/2008,7/8/2008,33,0,33
6/5/2008,6/5/2008,6/30/2008,25,0,25
6/6/2008,6/6/2008,6/25/2008,19,0,19
6/9/2008,6/9/2008,7/10/2008,31,0,31
6/10/2008,6/10/2008,7/10/2008,30,0,30
6/11/2008,6/11/2008,7/11/2008,30,0,30
6/12/2008,6/12/2008,6/20/2008,8,0,8
6/12/2008,6/12/2008,7/15/2008,33,0,33
6/12/2008,6/12/2008,7/17/2008,35,0,35
6/12/2008,6/12/2008,7/16/2008,34,0,34
6/13/2008,6/13/2008,6/26/2008,13,0,13
6/13/2008,6/13/2008,7/17/2008,34,0,34
6/16/2008,6/16/2008,9/18/2008,94,0,94
6/20/2008,6/20/2008,7/21/2008,31,0,31
6/20/2008,6/20/2008,7/21/2008,31,0,31
6/16/2008,6/16/2008,7/21/2008,35,0,35
6/23/2008,6/23/2008,7/10/2008,17,0,17
6/26/2008,6/26/2008,7/31/2008,35,0,35
6/26/2008,6/26/2008,7/11/2008,15,0,15
6/30/2008,6/30/2008,8/1/2008,32,0,32
7/3/2008,7/3/2008,7/11/2008,8,0,8
7/3/2008,7/3/2008,8/6/2008,34,0,34
7/3/2008,7/3/2008,8/7/2008,35,0,35
7/3/2008,7/3/2008,8/7/2008,35,0,35
7/4/2008,7/4/2008,8/8/2008,35,0,35
7/8/2008,7/8/2008,7/25/2008,17,0,17
7/8/2008,7/8/2008,8/12/2008,35,0,35
7/9/2008,7/9/2008,8/13/2008,35,0,35
7/9/2008,7/9/2008,10/14/2008,97,0,97
7/11/2008,7/11/2008,8/14/2008,34,0,34
7/11/2008,7/11/2008,8/18/2008,38,0,38
7/11/2008,7/11/2008,10/13/2008,94,0,94
7/11/2008,7/11/2008,8/18/2008,38,0,38
7/17/2008,7/17/2008,7/25/2008,8,0,8
7/15/2008,7/15/2008,8/18/2008,34,0,34
7/17/2008,7/17/2008,8/19/2008,33,0,33
7/17/2008,7/17/2008,8/21/2008,35,0,35
7/17/2008,7/17/2008,8/21/2008,35,0,35
7/23/2008,7/23/2008,8/11/2008,19,0,19
7/24/2008,7/24/2008,8/1/2008,8,0,8
7/24/2008,7/24/2008,8/6/2008,13,0,13
7/28/2008,7/28/2008,8/29/2008,32,0,32
7/29/2008,7/29/2008,8/29/2008,31,0,31
7/24/2008,7/24/2008,8/6/2008,13,0,13
7/30/2008,7/30/2008,9/3/2008,35,0,35
8/4/2008,8/4/2008,8/14/2008,10,0,10
8/5/2008,8/5/2008,9/5/2008,31,0,31
8/5/2008,8/5/2008,9/5/2008,31,0,31
8/5/2008,8/5/2008,8/13/2008,8,0,8
8/6/2008,8/6/2008,9/8/2008,33,0,33
8/7/2008,8/7/2008,8/26/2008,19,0,19
8/11/2008,8/11/2008,8/19/2008,8,0,8
8/12/2008,8/12/2008,8/26/2008,14,0,14
8/12/2008,8/12/2008,9/12/2008,31,0,31
8/12/2008,8/12/2008,8/13/2008,1,0,1
8/12/2008,8/12/2008,9/12/2008,31,0,31
8/12/2008,8/12/2008,8/14/2008,2,0,2
8/12/2008,8/12/2008,9/2/2008,21,0,21
8/13/2008,8/13/2008,9/16/2008,34,0,34
8/13/2008,8/13/2008,8/27/2008,14,0,14
8/13/2008,8/13/2008,8/14/2008,1,0,1
8/14/2008,8/14/2008,9/18/2008,35,0,35
8/14/2008,8/14/2008,9/16/2008,33,0,33
8/14/2008,8/14/2008,9/16/2008,33,0,33
8/18/2008,8/18/2008,8/19/2008,1,0,1
8/14/2008,8/14/2008,8/15/2008,1,0,1
8/14/2008,8/14/2008,8/15/2008,1,0,1
8/14/2008,8/14/2008,8/15/2008,1,0,1
8/14/2008,8/14/2008,8/15/2008,1,0,1
8/14/2008,8/14/2008,8/15/2008,1,0,1
8/18/2008,8/18/2008,8/22/2008,4,0,4
8/18/2008,8/18/2008,8/19/2008,1,0,1
8/15/2008,8/15/2008,8/18/2008,3,0,3
8/19/2008,8/19/2008,9/18/2008,30,0,30
8/19/2008,8/19/2008,9/18/2008,30,0,30
8/19/2008,8/19/2008,8/25/2008,6,0,6
8/19/2008,8/19/2008,9/22/2008,34,0,34
8/19/2008,8/19/2008,9/22/2008,34,0,34
8/19/2008,8/19/2008,9/22/2008,34,0,34
8/19/2008,8/19/2008,9/22/2008,34,0,34
8/19/2008,8/19/2008,8/28/2008,9,0,9
8/19/2008,8/19/2008,8/20/2008,1,0,1
8/19/2008,8/19/2008,8/25/2008,6,0,6
8/19/2008,8/19/2008,9/25/2008,37,0,37
8/20/2008,8/20/2008,8/21/2008,1,0,1
8/20/2008,8/20/2008,8/21/2008,1,0,1
8/20/2008,8/20/2008,9/9/2008,20,0,20
8/20/2008,8/20/2008,9/1/2008,12,0,12
8/21/2008,8/21/2008,9/10/2008,20,0,20
8/21/2008,8/21/2008,8/22/2008,1,0,1
8/21/2008,8/21/2008,8/22/2008,1,0,1
8/21/2008,8/21/2008,8/22/2008,1,0,1
8/21/2008,8/21/2008,9/4/2008,14,0,14
8/21/2008,8/21/2008,9/2/2008,12,0,12
8/21/2008,8/21/2008,8/29/2008,8,0,8
8/22/2008,8/22/2008,9/23/2008,32,0,32
8/22/2008,8/22/2008,8/25/2008,3,0,3
8/22/2008,8/22/2008,9/22/2008,31,0,31
8/25/2008,8/25/2008,8/26/2008,1,0,1
8/25/2008,8/25/2008,9/2/2008,8,0,8
8/25/2008,8/25/2008,8/26/2008,1,0,1
8/25/2008,8/25/2008,9/3/2008,9,0,9
8/25/2008,8/25/2008,9/25/2008,31,0,31
8/26/2008,8/26/2008,8/27/2008,1,0,1
8/26/2008,8/26/2008,9/5/2008,10,0,10
8/26/2008,8/26/2008,8/27/2008,1,0,1
8/26/2008,8/26/2008,8/20/2008,-6,0,-6
8/27/2008,8/27/2008,9/30/2008,34,0,34
8/27/2008,8/27/2008,8/28/2008,1,0,1
8/29/2008,8/29/2008,9/9/2008,11,0,11
8/28/2008,8/28/2008,9/3/2008,6,0,6
8/28/2008,8/28/2008,8/29/2008,1,0,1
8/28/2008,8/28/2008,8/29/2008,1,0,1
8/28/2008,8/28/2008,9/8/2008,11,0,11
8/29/2008,8/29/2008,9/4/2008,6,0,6
8/29/2008,8/29/2008,9/30/2008,32,0,32
8/29/2008,8/29/2008,9/2/2008,4,0,4
8/29/2008,8/29/2008,9/2/2008,4,0,4
9/1/2008,9/1/2008,10/2/2008,31,0,31
9/2/2008,9/2/2008,9/12/2008,10,0,10
9/2/2008,9/2/2008,9/3/2008,1,0,1
9/2/2008,9/2/2008,9/9/2008,7,0,7
9/2/2008,9/2/2008,9/17/2008,15,0,15
9/2/2008,9/2/2008,9/3/2008,1,0,1
9/2/2008,9/2/2008,10/1/2008,29,0,29
9/3/2008,9/3/2008,10/7/2008,34,0,34
9/3/2008,9/3/2008,9/9/2008,6,0,6
9/3/2008,9/3/2008,9/4/2008,1,0,1
9/3/2008,9/3/2008,9/4/2008,1,0,1
9/4/2008,9/4/2008,10/9/2008,35,0,35
9/4/2008,9/4/2008,9/10/2008,6,0,6
9/4/2008,9/4/2008,9/18/2008,14,0,14
9/4/2008,9/4/2008,9/18/2008,14,0,14
9/4/2008,9/4/2008,9/24/2008,20,0,20
9/5/2008,9/5/2008,9/8/2008,3,0,3
9/5/2008,9/5/2008,9/8/2008,3,0,3
9/8/2008,9/8/2008,9/25/2008,17,0,17
9/8/2008,9/8/2008,10/3/2008,25,0,25
9/8/2008,9/8/2008,10/6/2008,28,0,28
9/8/2008,9/8/2008,10/10/2008,32,0,32
9/8/2008,9/8/2008,9/9/2008,1,0,1
9/8/2008,9/8/2008,9/9/2008,1,0,1
9/8/2008,9/8/2008,9/22/2008,14,0,14
9/9/2008,9/9/2008,10/13/2008,34,0,34
9/9/2008,9/9/2008,10/13/2008,34,0,34
9/9/2008,9/9/2008,10/13/2008,34,0,34
9/9/2008,9/9/2008,9/10/2008,1,0,1
9/9/2008,9/9/2008,10/2/2008,23,0,23
9/9/2008,9/9/2008,9/10/2008,1,0,1
9/9/2008,9/9/2008,10/9/2008,30,0,30
9/9/2008,9/9/2008,9/30/2008,21,0,21
9/9/2008,9/9/2008,9/10/2008,1,0,1
9/9/2008,9/9/2008,9/10/2008,1,0,1
9/10/2008,9/10/2008,9/25/2008,15,0,15
9/10/2008,9/10/2008,10/16/2008,36,0,36
9/10/2008,9/10/2008,9/19/2008,9,0,9
9/11/2008,9/11/2008,10/15/2008,34,0,34
9/11/2008,9/11/2008,10/2/2008,21,0,21
9/12/2008,9/12/2008,10/16/2008,34,0,34
9/12/2008,9/12/2008,9/15/2008,3,0,3
9/15/2008,9/15/2008,9/26/2008,11,0,11
9/15/2008,9/15/2008,9/18/2008,3,0,3
9/16/2008,9/16/2008,10/20/2008,34,0,34
9/17/2008,9/17/2008,9/18/2008,1,0,1
9/17/2008,9/17/2008,9/18/2008,1,0,1
9/17/2008,9/17/2008,11/7/2008,51,0,51
9/18/2008,9/18/2008,9/19/2008,1,0,1
9/18/2008,9/18/2008,9/19/2008,1,0,1
9/18/2008,9/18/2008,9/19/2008,1,0,1
9/18/2008,9/18/2008,10/1/2008,13,0,13
9/18/2008,9/18/2008,10/21/2008,33,0,33
9/18/2008,9/18/2008,9/19/2008,1,0,1
9/18/2008,9/18/2008,9/22/2008,4,0,4
9/19/2008,9/19/2008,10/24/2008,35,0,35
9/19/2008,9/19/2008,9/22/2008,3,0,3
9/19/2008,9/19/2008,10/6/2008,17,0,17
9/22/2008,9/22/2008,9/25/2008,3,0,3
9/23/2008,9/23/2008,10/10/2008,17,0,17
9/23/2008,9/23/2008,10/7/2008,14,0,14
9/23/2008,9/23/2008,9/24/2008,1,0,1
9/24/2008,9/24/2008,9/25/2008,1,0,1
9/25/2008,9/25/2008,10/29/2008,34,0,34
9/25/2008,9/25/2008,9/26/2008,1,0,1
9/25/2008,9/25/2008,9/26/2008,1,0,1
9/26/2008,9/26/2008,9/29/2008,3,0,3
9/25/2008,9/25/2008,9/29/2008,4,0,4
9/26/2008,9/26/2008,10/31/2008,35,0,35
9/26/2008,9/26/2008,9/29/2008,3,0,3
9/26/2008,9/26/2008,9/29/2008,3,0,3
9/26/2008,9/26/2008,9/30/2008,4,0,4
9/29/2008,9/29/2008,9/30/2008,1,0,1
9/29/2008,9/29/2008,9/30/2008,1,0,1
9/29/2008,9/29/2008,9/30/2008,1,0,1
9/29/2008,9/29/2008,10/6/2008,7,0,7
9/29/2008,9/29/2008,9/30/2008,1,0,1
9/30/2008,9/30/2008,10/1/2008,1,0,1
9/30/2008,9/30/2008,10/1/2008,1,0,1
9/30/2008,9/30/2008,10/9/2008,9,0,9
10/1/2008,10/1/2008,11/3/2008,33,0,33
10/1/2008,10/1/2008,10/2/2008,1,0,1
10/1/2008,10/1/2008,10/2/2008,1,0,1
10/1/2008,10/1/2008,10/2/2008,1,0,1
10/1/2008,10/1/2008,10/2/2008,1,0,1
10/1/2008,10/1/2008,10/3/2008,2,0,2
10/2/2008,10/2/2008,10/3/2008,1,0,1
10/2/2008,10/2/2008,10/3/2008,1,0,1
10/3/2008,10/3/2008,11/7/2008,35,0,35
10/3/2008,10/3/2008,10/16/2008,13,0,13
10/3/2008,10/3/2008,10/7/2008,4,0,4
10/3/2008,10/3/2008,10/6/2008,3,0,3
10/3/2008,10/3/2008,10/6/2008,3,0,3
10/3/2008,10/3/2008,10/6/2008,3,0,3
10/6/2008,10/6/2008,10/7/2008,1,0,1
10/6/2008,10/6/2008,10/7/2008,1,0,1
10/6/2008,10/6/2008,10/7/2008,1,0,1
10/6/2008,10/6/2008,10/7/2008,1,0,1
10/6/2008,10/6/2008,10/8/2008,2,0,2
10/7/2008,10/7/2008,10/8/2008,1,0,1
10/7/2008,10/7/2008,10/8/2008,1,0,1
10/7/2008,10/7/2008,10/8/2008,1,0,1
10/7/2008,10/7/2008,10/9/2008,2,0,2
10/7/2008,10/7/2008,10/8/2008,1,0,1
10/8/2008,10/8/2008,10/9/2008,1,0,1
10/8/2008,10/8/2008,10/27/2008,19,0,19
10/8/2008,10/8/2008,10/15/2008,7,0,7
10/8/2008,10/8/2008,10/9/2008,1,0,1
10/8/2008,10/8/2008,10/9/2008,1,0,1
10/9/2008,10/9/2008,10/10/2008,1,0,1
10/9/2008,10/9/2008,11/14/2008,36,0,36
10/10/2008,10/10/2008,10/13/2008,3,0,3
10/9/2008,10/9/2008,10/10/2008,1,0,1
10/9/2008,10/9/2008,10/10/2008,1,0,1
10/9/2008,10/9/2008,10/13/2008,4,0,4
10/9/2008,10/9/2008,10/10/2008,1,0,1
10/10/2008,10/10/2008,10/14/2008,4,0,4
10/10/2008,10/10/2008,11/14/2008,35,0,35
10/10/2008,10/10/2008,11/18/2008,39,0,39
10/10/2008,10/10/2008,10/13/2008,3,0,3
10/10/2008,10/10/2008,10/14/2008,4,0,4
10/10/2008,10/10/2008,10/14/2008,4,0,4
10/10/2008,10/10/2008,11/14/2008,35,0,35
10/13/2008,10/13/2008,11/17/2008,35,0,35
10/13/2008,10/13/2008,10/14/2008,1,0,1
10/13/2008,10/13/2008,10/15/2008,2,0,2
10/13/2008,10/13/2008,10/21/2008,8,0,8
10/13/2008,10/13/2008,10/21/2008,8,0,8
10/14/2008,10/14/2008,11/17/2008,34,0,34
10/14/2008,10/14/2008,10/15/2008,1,0,1
10/14/2008,10/14/2008,10/15/2008,1,0,1
10/14/2008,10/14/2008,10/15/2008,1,0,1
10/15/2008,10/15/2008,10/16/2008,1,0,1
10/15/2008,10/15/2008,10/22/2008,7,0,7
10/15/2008,10/15/2008,11/17/2008,33,0,33
10/15/2008,10/15/2008,11/17/2008,33,0,33
10/15/2008,10/15/2008,10/27/2008,12,0,12
10/15/2008,10/15/2008,10/16/2008,1,0,1
10/15/2008,10/15/2008,10/16/2008,1,0,1
10/15/2008,10/15/2008,10/21/2008,6,0,6
10/15/2008,10/15/2008,10/16/2008,1,0,1
10/15/2008,10/15/2008,10/16/2008,1,0,1
10/15/2008,10/15/2008,10/16/2008,1,0,1
10/16/2008,10/16/2008,10/31/2008,15,0,15
10/16/2008,10/16/2008,11/19/2008,34,0,34
10/16/2008,10/16/2008,10/17/2008,1,0,1
10/16/2008,10/16/2008,10/17/2008,1,0,1
10/16/2008,10/16/2008,10/17/2008,1,0,1
10/16/2008,10/16/2008,10/17/2008,1,0,1
10/17/2008,10/17/2008,10/28/2008,11,0,11
10/17/2008,10/17/2008,11/3/2008,17,0,17
10/17/2008,10/17/2008,10/20/2008,3,0,3
10/17/2008,10/17/2008,10/20/2008,3,0,3
10/17/2008,10/17/2008,10/20/2008,3,0,3
10/17/2008,10/17/2008,10/20/2008,3,0,3
10/17/2008,10/17/2008,10/20/2008,3,0,3
10/20/2008,10/20/2008,10/21/2008,1,0,1
10/20/2008,10/20/2008,10/21/2008,1,0,1
10/20/2008,10/20/2008,10/21/2008,1,0,1
10/20/2008,10/20/2008,10/21/2008,1,0,1
10/21/2008,10/21/2008,10/27/2008,6,0,6
10/22/2008,10/22/2008,10/23/2008,1,0,1
10/21/2008,10/21/2008,10/22/2008,1,0,1
10/21/2008,10/21/2008,10/22/2008,1,0,1
10/21/2008,10/21/2008,10/22/2008,1,0,1
10/21/2008,10/21/2008,10/22/2008,1,0,1
10/22/2008,10/22/2008,10/23/2008,1,0,1
10/22/2008,10/22/2008,10/23/2008,1,0,1
10/23/2008,10/23/2008,10/24/2008,1,0,1
10/23/2008,10/23/2008,10/30/2008,7,0,7
10/23/2008,10/23/2008,10/24/2008,1,0,1
10/23/2008,10/23/2008,10/24/2008,1,0,1
10/23/2008,10/23/2008,10/24/2008,1,0,1
10/23/2008,10/23/2008,10/24/2008,1,0,1
10/23/2008,10/23/2008,10/24/2008,1,0,1
10/24/2008,10/24/2008,10/27/2008,3,0,3
10/24/2008,10/24/2008,10/27/2008,3,0,3
10/24/2008,10/24/2008,10/27/2008,3,0,3
10/24/2008,10/24/2008,11/4/2008,11,0,11
10/24/2008,10/24/2008,10/27/2008,3,0,3
10/24/2008,10/24/2008,10/27/2008,3,0,3
10/24/2008,10/24/2008,11/21/2008,28,0,28
10/24/2008,10/24/2008,10/27/2008,3,0,3
10/27/2008,10/27/2008,10/28/2008,1,0,1
10/27/2008,10/27/2008,11/6/2008,10,0,10
10/27/2008,10/27/2008,11/28/2008,32,0,32
10/27/2008,10/27/2008,10/28/2008,1,0,1
10/27/2008,10/27/2008,10/28/2008,1,0,1
10/27/2008,10/27/2008,11/3/2008,7,0,7
10/27/2008,10/27/2008,11/3/2008,7,0,7
10/27/2008,10/27/2008,10/28/2008,1,0,1
10/27/2008,10/27/2008,10/28/2008,1,0,1
10/28/2008,10/28/2008,10/29/2008,1,0,1
10/28/2008,10/28/2008,10/29/2008,1,0,1
10/28/2008,10/28/2008,10/29/2008,1,0,1
10/28/2008,10/28/2008,10/29/2008,1,0,1
10/28/2008,10/28/2008,11/5/2008,8,0,8
10/28/2008,10/28/2008,11/5/2008,8,0,8
10/29/2008,10/29/2008,11/5/2008,7,0,7
10/29/2008,10/29/2008,11/21/2008,23,0,23
10/29/2008,10/29/2008,10/30/2008,1,0,1
10/30/2008,10/30/2008,12/1/2008,32,0,32
10/30/2008,10/30/2008,12/3/2008,34,0,34
10/30/2008,10/30/2008,10/31/2008,1,0,1
10/30/2008,10/30/2008,11/6/2008,7,0,7
10/30/2008,10/30/2008,11/3/2008,4,0,4
10/30/2008,10/30/2008,11/14/2008,15,0,15
10/30/2008,10/30/2008,10/31/2008,1,0,1
10/30/2008,10/30/2008,10/31/2008,1,0,1
10/31/2008,10/31/2008,12/30/2008,60,0,60
10/31/2008,10/31/2008,11/3/2008,3,0,3
10/31/2008,10/31/2008,11/3/2008,3,0,3
11/3/2008,11/3/2008,11/4/2008,1,0,1
11/3/2008,11/3/2008,11/4/2008,1,0,1
11/3/2008,11/3/2008,11/4/2008,1,0,1
11/3/2008,11/3/2008,11/4/2008,1,0,1
11/3/2008,11/3/2008,11/18/2008,15,0,15
11/3/2008,11/3/2008,11/4/2008,1,0,1
11/3/2008,11/3/2008,11/10/2008,7,0,7
11/4/2008,11/4/2008,11/17/2008,13,0,13
11/4/2008,11/4/2008,11/5/2008,1,0,1
11/4/2008,11/4/2008,11/5/2008,1,0,1
11/4/2008,11/4/2008,11/5/2008,1,0,1
11/5/2008,11/5/2008,11/12/2008,7,0,7
11/4/2008,11/4/2008,11/5/2008,1,0,1
11/4/2008,11/4/2008,11/5/2008,1,0,1
11/4/2008,11/4/2008,11/5/2008,1,0,1
11/4/2008,11/4/2008,11/6/2008,2,0,2
11/5/2008,11/5/2008,11/6/2008,1,0,1
11/5/2008,11/5/2008,11/6/2008,1,0,1
11/5/2008,11/5/2008,11/7/2008,2,0,2
11/5/2008,11/5/2008,11/6/2008,1,0,1
11/6/2008,11/6/2008,12/8/2008,32,0,32
11/6/2008,11/6/2008,11/25/2008,19,0,19
11/6/2008,11/6/2008,12/5/2008,29,0,29
11/6/2008,11/6/2008,12/5/2008,29,0,29
11/6/2008,11/6/2008,11/7/2008,1,0,1
11/6/2008,11/6/2008,11/10/2008,4,0,4
11/6/2008,11/6/2008,11/12/2008,6,0,6
11/6/2008,11/6/2008,11/12/2008,6,0,6
11/7/2008,11/7/2008,11/12/2008,5,0,5
11/7/2008,11/7/2008,11/10/2008,3,0,3
11/7/2008,11/7/2008,11/14/2008,7,0,7
11/10/2008,11/10/2008,12/10/2008,30,0,30
11/10/2008,11/10/2008,11/12/2008,2,0,2
11/10/2008,11/10/2008,11/12/2008,2,0,2
11/10/2008,11/10/2008,11/12/2008,2,0,2
11/10/2008,11/10/2008,2/10/2009,92,0,92
11/10/2008,11/10/2008,12/10/2008,30,0,30
11/10/2008,11/10/2008,11/13/2008,3,0,3
11/10/2008,11/10/2008,11/12/2008,2,0,2
11/10/2008,11/10/2008,11/19/2008,9,0,9
11/11/2008,11/11/2008,11/12/2008,1,0,1
11/11/2008,11/11/2008,11/12/2008,1,0,1
11/11/2008,11/11/2008,11/12/2008,1,0,1
11/11/2008,11/11/2008,11/24/2008,13,0,13
11/12/2008,11/12/2008,12/12/2008,30,0,30
11/12/2008,11/12/2008,11/13/2008,1,0,1
11/12/2008,11/12/2008,11/13/2008,1,0,1
11/12/2008,11/12/2008,11/13/2008,1,0,1
11/12/2008,11/12/2008,11/13/2008,1,0,1
11/12/2008,11/12/2008,11/13/2008,1,0,1
11/12/2008,11/12/2008,11/14/2008,2,0,2
11/13/2008,11/13/2008,12/17/2008,34,0,34
11/13/2008,11/13/2008,11/26/2008,13,0,13
11/13/2008,11/13/2008,11/14/2008,1,0,1
11/13/2008,11/13/2008,11/14/2008,1,0,1
11/13/2008,11/13/2008,11/14/2008,1,0,1
11/14/2008,11/14/2008,12/15/2008,31,0,31
11/14/2008,11/14/2008,11/17/2008,3,0,3
11/14/2008,11/14/2008,11/17/2008,3,0,3
11/17/2008,11/17/2008,11/18/2008,1,0,1
11/14/2008,11/14/2008,11/17/2008,3,0,3
11/14/2008,11/14/2008,11/17/2008,3,0,3
11/17/2008,11/17/2008,12/19/2008,32,0,32
11/17/2008,11/17/2008,12/17/2008,30,0,30
11/17/2008,11/17/2008,11/18/2008,1,0,1
11/17/2008,11/17/2008,11/19/2008,2,0,2
11/17/2008,11/17/2008,11/24/2008,7,0,7
11/18/2008,11/18/2008,12/3/2008,15,0,15
11/18/2008,11/18/2008,11/26/2008,8,0,8
11/18/2008,11/18/2008,11/26/2008,8,0,8
11/18/2008,11/18/2008,11/19/2008,1,0,1
11/18/2008,11/18/2008,11/19/2008,1,0,1
11/18/2008,11/18/2008,11/19/2008,1,0,1
11/19/2008,11/19/2008,11/20/2008,1,0,1
11/19/2008,11/19/2008,12/2/2008,13,0,13
11/19/2008,11/19/2008,11/20/2008,1,0,1
11/19/2008,11/19/2008,11/20/2008,1,0,1
11/19/2008,11/19/2008,1/19/2009,61,0,61
11/19/2008,11/19/2008,11/21/2008,2,0,2
11/20/2008,11/20/2008,11/24/2008,4,0,4
11/20/2008,11/20/2008,11/21/2008,1,0,1
11/20/2008,11/20/2008,11/21/2008,1,0,1
11/20/2008,11/20/2008,11/25/2008,5,0,5
11/20/2008,11/20/2008,11/24/2008,4,0,4
11/20/2008,11/20/2008,11/28/2008,8,0,8
11/21/2008,11/21/2008,12/10/2008,19,0,19
11/21/2008,11/21/2008,11/24/2008,3,0,3
11/21/2008,11/21/2008,11/24/2008,3,0,3
11/21/2008,11/21/2008,12/1/2008,10,0,10
11/21/2008,11/21/2008,11/25/2008,4,0,4
11/24/2008,11/24/2008,11/25/2008,1,0,1
11/24/2008,11/24/2008,11/25/2008,1,0,1
11/24/2008,11/24/2008,12/4/2008,10,0,10
11/25/2008,11/25/2008,12/24/2008,29,0,29
11/25/2008,11/25/2008,11/26/2008,1,0,1
11/25/2008,11/25/2008,11/26/2008,1,0,1
11/25/2008,11/25/2008,11/26/2008,1,0,1
11/25/2008,11/25/2008,12/1/2008,6,0,6
11/25/2008,11/25/2008,12/2/2008,7,0,7
11/25/2008,11/25/2008,11/27/2008,2,0,2
11/26/2008,11/26/2008,12/5/2008,9,0,9
11/26/2008,11/26/2008,12/30/2008,34,0,34
11/26/2008,11/26/2008,12/1/2008,5,0,5
11/27/2008,11/27/2008,11/28/2008,1,0,1
11/27/2008,11/27/2008,12/8/2008,11,0,11
11/28/2008,11/28/2008,12/1/2008,3,0,3
11/28/2008,11/28/2008,12/17/2008,19,0,19
11/28/2008,11/28/2008,12/8/2008,10,0,10
12/1/2008,12/1/2008,1/7/2009,37,0,37
12/1/2008,12/1/2008,12/8/2008,7,0,7
12/1/2008,12/1/2008,12/2/2008,1,0,1
12/2/2008,12/2/2008,12/12/2008,10,0,10
12/2/2008,12/2/2008,1/8/2009,37,0,37
12/2/2008,12/2/2008,12/3/2008,1,0,1
12/2/2008,12/2/2008,12/9/2008,7,0,7
12/3/2008,12/3/2008,12/4/2008,1,0,1
12/3/2008,12/3/2008,12/4/2008,1,0,1
12/3/2008,12/3/2008,12/4/2008,1,0,1
12/4/2008,12/4/2008,1/9/2009,36,0,36
12/4/2008,12/4/2008,1/5/2009,32,0,32
12/4/2008,12/4/2008,3/3/2009,89,0,89
12/4/2008,12/4/2008,12/15/2008,11,0,11
12/4/2008,12/4/2008,12/10/2008,6,0,6
12/4/2008,12/4/2008,12/17/2008,13,0,13
12/4/2008,12/4/2008,1/27/2009,54,0,54
12/4/2008,12/4/2008,3/3/2009,89,0,89
12/4/2008,12/4/2008,12/11/2008,7,0,7
12/5/2008,12/5/2008,12/8/2008,3,0,3
12/5/2008,12/5/2008,3/5/2009,90,0,90
12/5/2008,12/5/2008,12/11/2008,6,0,6
12/5/2008,12/5/2008,12/8/2008,3,0,3
12/8/2008,12/8/2008,1/13/2009,36,0,36
12/8/2008,12/8/2008,1/7/2009,30,0,30
12/8/2008,12/8/2008,3/9/2009,91,0,91
12/9/2008,12/9/2008,1/14/2009,36,0,36
12/9/2008,12/9/2008,12/10/2008,1,0,1
12/9/2008,12/9/2008,3/13/2009,94,0,94
12/9/2008,12/9/2008,3/10/2009,91,0,91
12/10/2008,12/10/2008,12/11/2008,1,0,1
12/10/2008,12/10/2008,1/14/2009,35,0,35
12/10/2008,12/10/2008,1/15/2009,36,0,36
12/10/2008,12/10/2008,2/10/2009,62,0,62
12/11/2008,12/11/2008,12/12/2008,1,0,1
12/11/2008,12/11/2008,12/22/2008,11,0,11
12/11/2008,12/11/2008,12/18/2008,7,0,7
12/11/2008,12/11/2008,12/22/2008,11,0,11
12/11/2008,12/11/2008,1/16/2009,36,0,36
12/11/2008,12/11/2008,12/19/2008,8,0,8
12/11/2008,12/11/2008,12/19/2008,8,0,8
12/11/2008,12/11/2008,12/19/2008,8,0,8
12/12/2008,12/12/2008,12/15/2008,3,0,3
12/12/2008,12/12/2008,1/15/2009,34,0,34
12/12/2008,12/12/2008,1/15/2009,34,0,34
12/15/2008,12/15/2008,1/16/2009,32,0,32
12/15/2008,12/15/2008,12/16/2008,1,0,1
12/15/2008,12/15/2008,1/19/2009,35,0,35
12/15/2008,12/15/2008,1/19/2009,35,0,35
12/16/2008,12/16/2008,12/18/2008,2,0,2
12/16/2008,12/16/2008,1/16/2009,31,0,31
12/17/2008,12/17/2008,12/18/2008,1,0,1
12/17/2008,12/17/2008,1/2/2009,16,0,16
12/17/2008,12/17/2008,2/17/2009,62,0,62
12/17/2008,12/17/2008,1/14/2009,28,0,28
12/17/2008,12/17/2008,3/17/2009,90,0,90
12/17/2008,12/17/2008,1/16/2009,30,0,30
12/18/2008,12/18/2008,1/19/2009,32,0,32
12/18/2008,12/18/2008,12/19/2008,1,0,1
12/18/2008,12/18/2008,1/21/2009,34,0,34
12/18/2008,12/18/2008,1/7/2009,20,0,20
12/19/2008,12/19/2008,1/30/2009,42,0,42
12/19/2008,12/19/2008,12/22/2008,3,0,3
12/19/2008,12/19/2008,12/29/2008,10,0,10
12/26/2008,12/26/2008,12/22/2008,-4,0,-4
12/22/2008,12/22/2008,12/23/2008,1,0,1
12/22/2008,12/22/2008,12/29/2008,7,0,7
12/22/2008,12/22/2008,12/31/2008,9,0,9
12/29/2008,12/29/2008,12/30/2008,1,0,1
12/24/2008,12/24/2008,1/5/2009,12,0,12
12/24/2008,12/24/2008,1/5/2009,12,0,12
12/24/2008,12/24/2008,1/30/2009,37,0,37
12/30/2008,12/30/2008,1/7/2009,8,0,8
12/29/2008,12/29/2008,1/30/2009,32,0,32
12/31/2008,12/31/2008,1/6/2009,6,0,6
12/31/2008,12/31/2008,1/2/2009,2,0,2
12/31/2008,12/31/2008,1/12/2009,12,0,12
12/31/2008,12/31/2008,1/12/2009,12,0,12
1/2/2009,1/2/2009,1/5/2009,3,0,3
1/5/2009,1/5/2009,1/6/2009,1,0,1
1/5/2009,1/5/2009,2/3/2009,29,0,29
1/5/2009,1/5/2009,2/5/2009,31,0,31
1/5/2009,1/5/2009,2/4/2009,30,0,30
1/6/2009,1/6/2009,1/15/2009,9,0,9
1/6/2009,1/6/2009,2/9/2009,34,0,34
1/7/2009,1/7/2009,2/6/2009,30,0,30
1/7/2009,1/7/2009,2/6/2009,30,0,30
1/7/2009,1/7/2009,2/6/2009,30,0,30
1/7/2009,1/7/2009,2/9/2009,33,0,33
1/7/2009,1/7/2009,1/8/2009,1,0,1
1/8/2009,1/8/2009,1/9/2009,1,0,1
1/9/2009,1/9/2009,1/29/2009,20,0,20
1/9/2009,1/9/2009,1/12/2009,3,0,3
1/12/2009,1/12/2009,1/19/2009,7,0,7
1/12/2009,1/12/2009,1/13/2009,1,0,1
1/12/2009,1/12/2009,2/11/2009,30,0,30
1/12/2009,1/12/2009,2/11/2009,30,0,30
1/12/2009,1/12/2009,2/12/2009,31,0,31
1/13/2009,1/13/2009,1/13/2009,0,0,0
1/13/2009,1/13/2009,2/4/2009,22,0,22
1/13/2009,1/13/2009,2/12/2009,30,0,30
1/13/2009,1/13/2009,1/14/2009,1,0,1
1/13/2009,1/13/2009,2/12/2009,30,0,30
1/13/2009,1/13/2009,1/23/2009,10,0,10
1/13/2009,1/13/2009,1/23/2009,10,0,10
1/13/2009,1/13/2009,1/23/2009,10,0,10
1/14/2009,1/14/2009,2/12/2009,29,0,29
1/14/2009,1/14/2009,1/15/2009,1,0,1
1/15/2009,1/15/2009,2/17/2009,33,0,33
1/15/2009,1/15/2009,2/18/2009,34,0,34
1/15/2009,1/15/2009,1/21/2009,6,0,6
1/15/2009,1/15/2009,1/16/2009,1,0,1
1/16/2009,1/16/2009,1/20/2009,4,0,4
1/16/2009,1/16/2009,2/18/2009,33,0,33
1/16/2009,1/16/2009,1/22/2009,6,0,6
1/16/2009,1/16/2009,2/18/2009,33,0,33
1/16/2009,1/16/2009,1/19/2009,3,0,3
1/16/2009,1/16/2009,3/9/2009,52,0,52
1/16/2009,1/16/2009,1/19/2009,3,0,3
1/16/2009,1/16/2009,2/11/2009,26,0,26
1/16/2009,1/16/2009,1/19/2009,3,0,3
1/16/2009,1/16/2009,2/11/2009,26,0,26
1/16/2009,1/16/2009,3/13/2009,56,0,56
1/19/2009,1/19/2009,2/19/2009,31,0,31
1/19/2009,1/19/2009,1/26/2009,7,0,7
1/20/2009,1/20/2009,1/21/2009,1,0,1
1/21/2009,1/21/2009,1/22/2009,1,0,1
1/21/2009,1/21/2009,2/19/2009,29,0,29
1/21/2009,1/21/2009,2/23/2009,33,0,33
1/21/2009,1/21/2009,2/5/2009,15,0,15
1/21/2009,1/21/2009,2/5/2009,15,0,15
1/22/2009,1/22/2009,2/20/2009,29,0,29
1/22/2009,1/22/2009,2/10/2009,19,0,19
1/23/2009,1/23/2009,1/29/2009,6,0,6
1/23/2009,1/23/2009,2/23/2009,31,0,31
1/23/2009,1/23/2009,2/23/2009,31,0,31
1/23/2009,1/23/2009,2/23/2009,31,0,31
1/23/2009,1/23/2009,2/2/2009,10,0,10
1/23/2009,1/23/2009,2/23/2009,31,0,31
1/28/2009,1/28/2009,1/29/2009,1,0,1
1/28/2009,1/28/2009,2/27/2009,30,0,30
1/30/2009,1/30/2009,2/2/2009,3,0,3
1/30/2009,1/30/2009,2/5/2009,6,0,6
1/30/2009,1/30/2009,3/4/2009,33,0,33
2/2/2009,2/2/2009,2/3/2009,1,0,1
2/2/2009,2/2/2009,2/9/2009,7,0,7
2/2/2009,2/2/2009,2/9/2009,7,0,7
2/3/2009,2/3/2009,2/4/2009,1,0,1
2/3/2009,2/3/2009,2/17/2009,14,0,14
2/3/2009,2/3/2009,2/23/2009,20,0,20
2/3/2009,2/3/2009,2/5/2009,2,0,2
2/3/2009,2/3/2009,2/23/2009,20,0,20
2/4/2009,2/4/2009,2/5/2009,1,0,1
2/5/2009,2/5/2009,3/6/2009,29,0,29
2/5/2009,2/5/2009,3/6/2009,29,0,29
2/5/2009,2/5/2009,3/9/2009,32,0,32
2/6/2009,2/6/2009,2/16/2009,10,0,10
2/6/2009,2/6/2009,2/25/2009,19,0,19
2/6/2009,2/6/2009,3/10/2009,32,0,32
2/6/2009,2/6/2009,3/10/2009,32,0,32
2/9/2009,2/9/2009,2/10/2009,1,0,1
2/9/2009,2/9/2009,3/11/2009,30,0,30
2/9/2009,2/9/2009,3/10/2009,29,0,29
2/9/2009,2/9/2009,3/10/2009,29,0,29
2/10/2009,2/10/2009,2/11/2009,1,0,1
2/10/2009,2/10/2009,3/12/2009,30,0,30
2/10/2009,2/10/2009,3/12/2009,30,0,30
2/10/2009,2/10/2009,3/12/2009,30,0,30
2/10/2009,2/10/2009,4/9/2009,58,0,58
2/10/2009,2/10/2009,4/9/2009,58,0,58
2/10/2009,2/10/2009,3/10/2009,28,0,28
2/11/2009,2/11/2009,2/12/2009,1,0,1
2/12/2009,2/12/2009,4/9/2009,56,0,56
2/12/2009,2/12/2009,3/12/2009,28,0,28
2/12/2009,2/12/2009,3/16/2009,32,0,32
2/12/2009,2/12/2009,2/23/2009,11,0,11
2/12/2009,2/12/2009,2/23/2009,11,0,11
2/12/2009,2/12/2009,2/20/2009,8,0,8
2/13/2009,2/13/2009,3/17/2009,32,0,32
2/13/2009,2/13/2009,2/16/2009,3,0,3
2/13/2009,2/13/2009,2/17/2009,4,0,4
2/13/2009,2/13/2009,4/6/2009,52,0,52
2/16/2009,2/16/2009,2/25/2009,9,0,9
2/16/2009,2/16/2009,2/17/2009,1,0,1
2/16/2009,2/16/2009,2/17/2009,1,0,1
2/16/2009,2/16/2009,3/3/2009,15,0,15
2/17/2009,2/17/2009,3/19/2009,30,0,30
2/18/2009,2/18/2009,2/19/2009,1,0,1
2/18/2009,2/18/2009,2/26/2009,8,0,8
2/18/2009,2/18/2009,2/26/2009,8,0,8
2/18/2009,2/18/2009,2/26/2009,8,0,8
2/18/2009,2/18/2009,4/22/2009,63,0,63
2/19/2009,2/19/2009,3/23/2009,32,0,32
2/19/2009,2/19/2009,2/26/2009,7,0,7
2/19/2009,2/19/2009,4/20/2009,60,0,60
2/20/2009,2/20/2009,2/23/2009,3,0,3
2/20/2009,2/20/2009,3/24/2009,32,0,32
2/23/2009,2/23/2009,3/12/2009,17,0,17
2/23/2009,2/23/2009,2/24/2009,1,0,1
2/23/2009,2/23/2009,3/9/2009,14,0,14
2/23/2009,2/23/2009,3/10/2009,15,0,15
2/23/2009,2/23/2009,3/9/2009,14,0,14
2/23/2009,2/23/2009,3/9/2009,14,0,14
2/23/2009,2/23/2009,3/9/2009,14,0,14
2/24/2009,2/24/2009,2/25/2009,1,0,1
2/24/2009,2/24/2009,4/27/2009,62,0,62
2/25/2009,2/25/2009,2/26/2009,1,0,1
2/25/2009,2/25/2009,3/31/2009,34,0,34
2/25/2009,2/25/2009,3/30/2009,33,0,33
2/25/2009,2/25/2009,4/2/2009,36,0,36
2/25/2009,2/25/2009,4/27/2009,61,0,61
2/25/2009,2/25/2009,3/5/2009,8,0,8
2/25/2009,2/25/2009,4/27/2009,61,0,61
2/26/2009,2/26/2009,3/9/2009,11,0,11
2/26/2009,2/26/2009,3/9/2009,11,0,11
2/26/2009,2/26/2009,5/27/2009,90,0,90
2/26/2009,2/26/2009,3/6/2009,8,0,8
2/26/2009,2/26/2009,3/6/2009,8,0,8
3/2/2009,3/2/2009,3/3/2009,1,0,1
3/2/2009,3/2/2009,4/3/2009,32,0,32
3/2/2009,3/2/2009,6/4/2009,94,0,94
3/3/2009,3/3/2009,4/1/2009,29,0,29
3/3/2009,3/3/2009,4/3/2009,31,0,31
3/3/2009,3/3/2009,6/1/2009,90,0,90
3/4/2009,3/4/2009,3/5/2009,1,0,1
3/5/2009,3/5/2009,3/6/2009,1,0,1
3/5/2009,3/5/2009,4/7/2009,33,0,33
3/6/2009,3/6/2009,4/8/2009,33,0,33
3/6/2009,3/6/2009,3/13/2009,7,0,7
3/6/2009,3/6/2009,3/9/2009,3,0,3
3/6/2009,3/6/2009,3/23/2009,17,0,17
3/6/2009,3/6/2009,5/11/2009,66,0,66
3/6/2009,3/6/2009,5/8/2009,63,0,63
3/6/2009,3/6/2009,6/9/2009,95,0,95
3/6/2009,3/6/2009,6/12/2009,98,0,98
3/9/2009,3/9/2009,3/10/2009,1,0,1
3/9/2009,3/9/2009,3/25/2009,16,0,16
3/9/2009,3/9/2009,3/13/2009,4,0,4
3/9/2009,3/9/2009,4/14/2009,36,0,36
3/10/2009,3/10/2009,3/11/2009,1,0,1
3/10/2009,3/10/2009,4/14/2009,35,0,35
3/11/2009,3/11/2009,6/12/2009,93,0,93
3/11/2009,3/11/2009,6/12/2009,93,0,93
3/11/2009,3/11/2009,3/12/2009,1,0,1
3/12/2009,3/12/2009,5/12/2009,61,0,61
3/12/2009,3/12/2009,4/20/2009,39,0,39
3/13/2009,3/13/2009,3/20/2009,7,0,7
3/13/2009,3/13/2009,3/16/2009,3,0,3
3/13/2009,3/13/2009,4/17/2009,35,0,35
3/16/2009,3/16/2009,6/18/2009,94,0,94
3/16/2009,3/16/2009,4/16/2009,31,0,31
3/16/2009,3/16/2009,3/17/2009,1,0,1
3/16/2009,3/16/2009,3/26/2009,10,0,10
3/17/2009,3/17/2009,3/18/2009,1,0,1
3/18/2009,3/18/2009,3/19/2009,1,0,1
3/18/2009,3/18/2009,4/1/2009,14,0,14
3/18/2009,3/18/2009,6/16/2009,90,0,90
3/18/2009,3/18/2009,4/20/2009,33,0,33
3/19/2009,3/19/2009,3/27/2009,8,0,8
3/19/2009,3/19/2009,3/27/2009,8,0,8
3/20/2009,3/20/2009,3/23/2009,3,0,3
3/23/2009,3/23/2009,4/21/2009,29,0,29
3/23/2009,3/23/2009,4/21/2009,29,0,29
3/23/2009,3/23/2009,3/24/2009,1,0,1
3/23/2009,3/23/2009,3/27/2009,4,0,4
3/23/2009,3/23/2009,5/22/2009,60,0,60
3/23/2009,3/23/2009,3/30/2009,7,0,7
3/23/2009,3/23/2009,3/30/2009,7,0,7
3/23/2009,3/23/2009,4/23/2009,31,0,31
3/24/2009,3/24/2009,3/25/2009,1,0,1
3/24/2009,3/24/2009,4/7/2009,14,0,14
3/25/2009,3/25/2009,3/26/2009,1,0,1
3/25/2009,3/25/2009,5/22/2009,58,0,58
3/26/2009,3/26/2009,3/27/2009,1,0,1
3/26/2009,3/26/2009,3/31/2009,5,0,5
3/26/2009,3/26/2009,4/28/2009,33,0,33
3/26/2009,3/26/2009,4/29/2009,34,0,34
3/30/2009,3/30/2009,3/31/2009,1,0,1
3/27/2009,3/27/2009,4/28/2009,32,0,32
3/27/2009,3/27/2009,3/30/2009,3,0,3
3/27/2009,3/27/2009,4/3/2009,7,0,7
3/30/2009,3/30/2009,4/6/2009,7,0,7
3/30/2009,3/30/2009,4/29/2009,30,0,30
3/31/2009,3/31/2009,5/6/2009,36,0,36
3/30/2009,3/30/2009,4/29/2009,30,0,30
3/31/2009,3/31/2009,4/1/2009,1,0,1
3/31/2009,3/31/2009,5/6/2009,36,0,36
3/31/2009,3/31/2009,5/6/2009,36,0,36
4/1/2009,4/1/2009,4/2/2009,1,0,1
4/2/2009,4/2/2009,4/8/2009,6,0,6
4/3/2009,4/3/2009,4/14/2009,11,0,11
4/3/2009,4/3/2009,5/6/2009,33,0,33
4/3/2009,4/3/2009,4/6/2009,3,0,3
4/3/2009,4/3/2009,4/14/2009,11,0,11
4/3/2009,4/3/2009,5/11/2009,38,0,38
4/6/2009,4/6/2009,6/9/2009,64,0,64
4/6/2009,4/6/2009,4/7/2009,1,0,1
4/6/2009,4/6/2009,5/12/2009,36,0,36
4/7/2009,4/7/2009,4/8/2009,1,0,1
4/7/2009,4/7/2009,7/7/2009,91,0,91
4/7/2009,4/7/2009,4/15/2009,8,0,8
4/9/2009,4/9/2009,4/14/2009,5,0,5
4/9/2009,4/9/2009,4/15/2009,6,0,6
4/22/2009,4/22/2009,6/9/2009,48,0,48
4/9/2009,4/9/2009,5/18/2009,39,0,39
4/9/2009,4/9/2009,5/15/2009,36,0,36
4/9/2009,4/9/2009,4/27/2009,18,0,18
4/9/2009,4/9/2009,4/17/2009,8,0,8
4/9/2009,4/9/2009,7/9/2009,91,0,91
4/10/2009,4/10/2009,5/15/2009,35,0,35
4/14/2009,4/14/2009,4/15/2009,1,0,1
4/15/2009,4/15/2009,5/18/2009,33,0,33
4/22/2009,4/22/2009,5/15/2009,23,0,23
4/22/2009,4/22/2009,6/15/2009,54,0,54
4/15/2009,4/15/2009,7/16/2009,92,0,92
4/16/2009,4/16/2009,4/17/2009,1,0,1
4/16/2009,4/16/2009,5/15/2009,29,0,29
4/17/2009,4/17/2009,4/24/2009,7,0,7
4/17/2009,4/17/2009,5/20/2009,33,0,33
4/17/2009,4/17/2009,5/20/2009,33,0,33
4/17/2009,4/17/2009,5/20/2009,33,0,33
4/20/2009,4/20/2009,7/20/2009,91,0,91
4/20/2009,4/20/2009,4/21/2009,1,0,1
4/20/2009,4/20/2009,4/27/2009,7,0,7
4/21/2009,4/21/2009,4/28/2009,7,0,7
4/21/2009,4/21/2009,4/22/2009,1,0,1
4/22/2009,4/22/2009,7/22/2009,91,0,91
4/22/2009,4/22/2009,4/28/2009,6,0,6
4/22/2009,4/22/2009,4/23/2009,1,0,1
4/22/2009,4/22/2009,5/11/2009,19,0,19
4/22/2009,4/22/2009,6/12/2009,51,0,51
4/22/2009,4/22/2009,5/11/2009,19,0,19
4/22/2009,4/22/2009,5/12/2009,20,0,20
4/22/2009,4/22/2009,5/11/2009,19,0,19
4/22/2009,4/22/2009,5/27/2009,35,0,35
4/22/2009,4/22/2009,5/11/2009,19,0,19
4/22/2009,4/22/2009,5/11/2009,19,0,19
4/22/2009,4/22/2009,5/11/2009,19,0,19
4/22/2009,4/22/2009,5/11/2009,19,0,19
4/22/2009,4/22/2009,5/20/2009,28,0,28
4/23/2009,4/23/2009,5/22/2009,29,0,29
4/23/2009,4/23/2009,5/22/2009,29,0,29
4/23/2009,4/23/2009,5/26/2009,33,0,33
4/23/2009,4/23/2009,4/24/2009,1,0,1
4/23/2009,4/23/2009,5/26/2009,33,0,33
4/23/2009,4/24/2009,5/5/2009,11,1,12
4/24/2009,4/24/2009,4/27/2009,3,0,3
4/24/2009,4/24/2009,5/5/2009,11,0,11
4/27/2009,4/27/2009,4/28/2009,1,0,1
4/27/2009,4/27/2009,5/29/2009,32,0,32
4/27/2009,4/27/2009,5/27/2009,30,0,30
4/27/2009,4/27/2009,5/11/2009,14,0,14
4/28/2009,4/28/2009,4/29/2009,1,0,1
4/28/2009,4/28/2009,6/24/2009,57,0,57
4/28/2009,4/28/2009,5/28/2009,30,0,30
4/28/2009,4/28/2009,5/4/2009,6,0,6
4/29/2009,4/29/2009,5/29/2009,30,0,30
4/29/2009,4/29/2009,5/29/2009,30,0,30
4/29/2009,4/29/2009,5/7/2009,8,0,8
4/29/2009,4/29/2009,5/29/2009,30,0,30
5/6/2009,5/6/2009,5/11/2009,5,0,5
5/4/2009,5/4/2009,5/5/2009,1,0,1
5/5/2009,5/5/2009,6/5/2009,31,0,31
5/5/2009,5/5/2009,5/11/2009,6,0,6
5/5/2009,5/5/2009,6/4/2009,30,0,30
5/6/2009,5/6/2009,6/4/2009,29,0,29
5/5/2009,5/5/2009,5/11/2009,6,0,6
5/6/2009,5/6/2009,5/7/2009,1,0,1
5/6/2009,5/6/2009,6/5/2009,30,0,30
5/6/2009,5/6/2009,6/5/2009,30,0,30
5/6/2009,5/6/2009,6/8/2009,33,0,33
5/6/2009,5/6/2009,6/5/2009,30,0,30
5/6/2009,5/6/2009,5/29/2009,23,0,23
5/6/2009,5/6/2009,5/11/2009,5,0,5
5/6/2009,5/6/2009,6/1/2009,26,0,26
5/6/2009,5/6/2009,5/11/2009,5,0,5
5/6/2009,5/6/2009,5/11/2009,5,0,5
5/6/2009,5/6/2009,6/4/2009,29,0,29
5/14/2009,5/14/2009,6/17/2009,34,0,34
5/7/2009,5/7/2009,5/21/2009,14,0,14
5/7/2009,5/7/2009,7/7/2009,61,0,61
5/7/2009,5/7/2009,5/18/2009,11,0,11
5/7/2009,5/7/2009,7/8/2009,62,0,62
5/7/2009,5/7/2009,5/26/2009,19,0,19
5/11/2009,5/11/2009,5/18/2009,7,0,7
5/11/2009,5/11/2009,5/15/2009,4,0,4
5/11/2009,5/11/2009,7/10/2009,60,0,60
5/12/2009,5/12/2009,6/12/2009,31,0,31
5/14/2009,5/14/2009,6/11/2009,28,0,28
5/12/2009,5/12/2009,7/15/2009,64,0,64
5/13/2009,5/13/2009,5/14/2009,1,0,1
5/13/2009,5/13/2009,6/15/2009,33,0,33
5/14/2009,5/14/2009,5/15/2009,1,0,1
5/14/2009,5/14/2009,6/12/2009,29,0,29
5/14/2009,5/14/2009,6/16/2009,33,0,33
5/15/2009,5/15/2009,6/12/2009,28,0,28
5/15/2009,5/15/2009,5/15/2009,0,0,0
5/15/2009,5/15/2009,5/18/2009,3,0,3
5/15/2009,5/15/2009,5/20/2009,5,0,5
5/18/2009,5/18/2009,7/15/2009,58,0,58
5/18/2009,5/18/2009,5/19/2009,1,0,1
5/19/2009,5/19/2009,5/20/2009,1,0,1
5/20/2009,5/20/2009,5/22/2009,2,0,2
5/20/2009,5/20/2009,6/23/2009,34,0,34
5/26/2009,5/26/2009,6/26/2009,31,0,31
5/22/2009,5/22/2009,6/2/2009,11,0,11
5/26/2009,5/26/2009,5/29/2009,3,0,3
5/26/2009,5/26/2009,5/29/2009,3,0,3
5/27/2009,5/27/2009,5/29/2009,2,0,2
5/27/2009,5/27/2009,6/12/2009,16,0,16
5/27/2009,5/27/2009,5/28/2009,1,0,1
5/27/2009,5/27/2009,6/26/2009,30,0,30
5/27/2009,5/27/2009,8/27/2009,92,0,92
5/27/2009,5/27/2009,6/30/2009,34,0,34
5/27/2009,5/27/2009,6/30/2009,34,0,34
5/27/2009,5/27/2009,6/30/2009,34,0,34
5/28/2009,5/28/2009,5/29/2009,1,0,1
5/28/2009,5/28/2009,6/29/2009,32,0,32
5/29/2009,5/29/2009,7/2/2009,34,0,34
5/29/2009,5/29/2009,6/12/2009,14,0,14
5/29/2009,5/29/2009,6/2/2009,4,0,4
5/29/2009,5/29/2009,7/1/2009,33,0,33
6/2/2009,6/2/2009,6/3/2009,1,0,1
6/2/2009,6/2/2009,6/3/2009,1,0,1
6/2/2009,6/2/2009,7/15/2009,43,0,43
6/3/2009,6/3/2009,6/4/2009,1,0,1
6/3/2009,6/3/2009,7/2/2009,29,0,29
6/3/2009,6/3/2009,8/4/2009,62,0,62
6/3/2009,6/3/2009,7/7/2009,34,0,34
6/4/2009,6/4/2009,6/5/2009,1,0,1
6/4/2009,6/4/2009,6/15/2009,11,0,11
6/4/2009,6/4/2009,7/6/2009,32,0,32
6/4/2009,6/4/2009,8/6/2009,63,0,63
6/5/2009,6/5/2009,6/12/2009,7,0,7
6/5/2009,6/5/2009,7/8/2009,33,0,33
6/5/2009,6/5/2009,7/8/2009,33,0,33
6/5/2009,6/5/2009,7/6/2009,31,0,31
6/5/2009,6/5/2009,7/8/2009,33,0,33
6/8/2009,6/8/2009,6/9/2009,1,0,1
6/8/2009,6/8/2009,6/25/2009,17,0,17
6/9/2009,6/9/2009,8/11/2009,63,0,63
6/16/2009,6/16/2009,6/17/2009,1,0,1
6/9/2009,6/9/2009,7/9/2009,30,0,30
6/9/2009,6/9/2009,6/10/2009,1,0,1
6/10/2009,6/10/2009,6/11/2009,1,0,1
6/10/2009,6/10/2009,7/13/2009,33,0,33
6/10/2009,6/10/2009,7/10/2009,30,0,30
6/10/2009,6/10/2009,6/29/2009,19,0,19
6/10/2009,6/10/2009,7/16/2009,36,0,36
6/11/2009,6/11/2009,6/22/2009,11,0,11
6/11/2009,6/11/2009,7/13/2009,32,0,32
6/11/2009,6/11/2009,7/10/2009,29,0,29
6/11/2009,6/11/2009,7/13/2009,32,0,32
6/11/2009,6/11/2009,8/14/2009,64,0,64
6/11/2009,6/11/2009,6/29/2009,18,0,18
6/11/2009,6/11/2009,7/14/2009,33,0,33
6/11/2009,6/11/2009,7/13/2009,32,0,32
6/11/2009,6/11/2009,6/19/2009,8,0,8
6/12/2009,6/12/2009,7/17/2009,35,0,35
6/15/2009,6/15/2009,7/16/2009,31,0,31
6/15/2009,6/15/2009,6/19/2009,4,0,4
6/15/2009,6/15/2009,6/16/2009,1,0,1
6/15/2009,6/15/2009,6/19/2009,4,0,4
6/16/2009,6/16/2009,8/17/2009,62,0,62
6/16/2009,6/16/2009,6/17/2009,1,0,1
6/16/2009,6/16/2009,7/6/2009,20,0,20
6/17/2009,6/17/2009,8/18/2009,62,0,62
6/18/2009,6/18/2009,6/29/2009,11,0,11
6/18/2009,6/18/2009,6/26/2009,8,0,8
6/22/2009,6/22/2009,6/23/2009,1,0,1
6/22/2009,6/22/2009,6/25/2009,3,0,3
6/23/2009,6/23/2009,7/24/2009,31,0,31
6/23/2009,6/23/2009,6/24/2009,1,0,1
6/25/2009,6/25/2009,7/27/2009,32,0,32
6/25/2009,6/25/2009,7/30/2009,35,0,35
6/25/2009,6/25/2009,7/30/2009,35,0,35
6/25/2009,6/25/2009,7/6/2009,11,0,11
6/26/2009,6/26/2009,8/26/2009,61,0,61
6/26/2009,6/26/2009,8/26/2009,61,0,61
6/26/2009,6/26/2009,7/6/2009,10,0,10
6/26/2009,6/26/2009,7/31/2009,35,0,35
6/26/2009,6/26/2009,7/31/2009,35,0,35
6/29/2009,6/29/2009,7/13/2009,14,0,14
6/29/2009,6/29/2009,7/29/2009,30,0,30
6/29/2009,6/29/2009,7/29/2009,30,0,30
6/29/2009,6/29/2009,6/30/2009,1,0,1
6/30/2009,6/30/2009,8/28/2009,59,0,59
6/30/2009,6/30/2009,7/1/2009,1,0,1
7/1/2009,7/1/2009,7/31/2009,30,0,30
7/1/2009,7/1/2009,8/3/2009,33,0,33
7/1/2009,7/1/2009,7/2/2009,1,0,1
7/2/2009,7/2/2009,8/3/2009,32,0,32
7/2/2009,7/2/2009,7/3/2009,1,0,1
7/3/2009,7/3/2009,8/3/2009,31,0,31
7/3/2009,7/3/2009,8/7/2009,35,0,35
7/3/2009,7/3/2009,7/6/2009,3,0,3
7/3/2009,7/3/2009,7/6/2009,3,0,3
7/3/2009,7/3/2009,8/26/2009,54,0,54
7/6/2009,7/6/2009,7/10/2009,4,0,4
7/6/2009,7/6/2009,9/8/2009,64,0,64
7/6/2009,7/6/2009,8/6/2009,31,0,31
7/6/2009,7/6/2009,9/9/2009,65,0,65
7/6/2009,7/6/2009,8/6/2009,31,0,31
7/6/2009,7/6/2009,8/10/2009,35,0,35
7/6/2009,7/6/2009,8/10/2009,35,0,35
7/6/2009,7/6/2009,8/10/2009,35,0,35
7/6/2009,7/6/2009,8/10/2009,35,0,35
7/7/2009,7/7/2009,9/9/2009,64,0,64
7/7/2009,7/7/2009,9/8/2009,63,0,63
7/7/2009,7/7/2009,7/8/2009,1,0,1
7/8/2009,7/8/2009,9/8/2009,62,0,62
7/8/2009,7/8/2009,7/9/2009,1,0,1
7/8/2009,7/8/2009,7/27/2009,19,0,19
7/9/2009,7/9/2009,8/10/2009,32,0,32
7/9/2009,7/9/2009,8/12/2009,34,0,34
7/9/2009,7/9/2009,7/10/2009,1,0,1
7/10/2009,7/10/2009,8/10/2009,31,0,31
7/10/2009,7/10/2009,7/13/2009,3,0,3
7/10/2009,7/10/2009,10/9/2009,91,0,91
7/10/2009,7/10/2009,8/10/2009,31,0,31
7/10/2009,7/10/2009,10/8/2009,90,0,90
7/10/2009,7/10/2009,7/17/2009,7,0,7
7/10/2009,7/10/2009,7/15/2009,5,0,5
7/13/2009,7/13/2009,8/14/2009,32,0,32
7/13/2009,7/13/2009,8/11/2009,29,0,29
7/13/2009,7/13/2009,10/13/2009,92,0,92
7/13/2009,7/13/2009,10/8/2009,87,0,87
7/15/2009,7/15/2009,7/20/2009,5,0,5
7/15/2009,7/15/2009,7/16/2009,1,0,1
7/16/2009,7/16/2009,10/14/2009,90,0,90
7/16/2009,7/16/2009,8/17/2009,32,0,32
7/16/2009,7/16/2009,8/14/2009,29,0,29
7/16/2009,7/16/2009,7/17/2009,1,0,1
7/17/2009,7/17/2009,8/17/2009,31,0,31
7/17/2009,7/17/2009,8/18/2009,32,0,32
7/17/2009,7/17/2009,8/18/2009,32,0,32
7/17/2009,7/17/2009,7/20/2009,3,0,3
7/17/2009,7/17/2009,8/27/2009,41,0,41
7/20/2009,7/20/2009,8/19/2009,30,0,30
7/20/2009,7/20/2009,8/20/2009,31,0,31
7/20/2009,7/20/2009,8/19/2009,30,0,30
7/20/2009,7/20/2009,7/21/2009,1,0,1
7/21/2009,7/21/2009,7/22/2009,1,0,1
7/22/2009,7/22/2009,7/23/2009,1,0,1
7/22/2009,7/22/2009,8/24/2009,33,0,33
7/22/2009,7/22/2009,8/24/2009,33,0,33
7/23/2009,7/23/2009,8/10/2009,18,0,18
7/24/2009,7/24/2009,7/31/2009,7,0,7
7/24/2009,7/24/2009,7/31/2009,7,0,7
7/24/2009,7/24/2009,8/24/2009,31,0,31
7/24/2009,7/24/2009,8/6/2009,13,0,13
7/24/2009,7/24/2009,7/27/2009,3,0,3
7/24/2009,7/24/2009,8/3/2009,10,0,10
7/24/2009,7/24/2009,7/27/2009,3,0,3
7/27/2009,7/27/2009,8/19/2009,23,0,23
7/27/2009,7/27/2009,10/26/2009,91,0,91
7/28/2009,7/28/2009,8/28/2009,31,0,31
7/28/2009,7/28/2009,8/28/2009,31,0,31
7/29/2009,7/29/2009,9/1/2009,34,0,34
7/29/2009,7/29/2009,8/18/2009,20,0,20
7/29/2009,7/29/2009,7/30/2009,1,0,1
7/29/2009,7/29/2009,8/28/2009,30,0,30
7/29/2009,7/29/2009,8/28/2009,30,0,30
7/30/2009,7/30/2009,7/31/2009,1,0,1
7/30/2009,7/30/2009,8/14/2009,15,0,15
7/30/2009,7/30/2009,9/2/2009,34,0,34
8/3/2009,8/3/2009,9/1/2009,29,0,29
7/31/2009,7/31/2009,8/7/2009,7,0,7
8/3/2009,8/3/2009,9/2/2009,30,0,30
8/3/2009,8/3/2009,9/3/2009,31,0,31
8/4/2009,8/4/2009,10/5/2009,62,0,62
8/4/2009,8/4/2009,8/5/2009,1,0,1
8/5/2009,8/5/2009,9/7/2009,33,0,33
8/5/2009,8/5/2009,8/6/2009,1,0,1
8/5/2009,8/5/2009,8/17/2009,12,0,12
8/5/2009,8/5/2009,8/17/2009,12,0,12
8/6/2009,8/6/2009,9/4/2009,29,0,29
8/6/2009,8/6/2009,9/8/2009,33,0,33
8/6/2009,8/6/2009,8/7/2009,1,0,1
8/6/2009,8/6/2009,8/14/2009,8,0,8
8/7/2009,8/7/2009,8/10/2009,3,0,3
8/7/2009,8/7/2009,8/17/2009,10,0,10
8/10/2009,8/10/2009,10/13/2009,64,0,64
8/10/2009,8/10/2009,8/17/2009,7,0,7
8/10/2009,8/10/2009,9/8/2009,29,0,29
8/10/2009,8/10/2009,9/10/2009,31,0,31
8/10/2009,8/10/2009,8/11/2009,1,0,1
8/10/2009,8/10/2009,9/14/2009,35,0,35
8/10/2009,8/10/2009,10/13/2009,64,0,64
8/12/2009,8/11/2009,9/11/2009,31,-1,30
8/11/2009,8/11/2009,8/12/2009,1,0,1
8/12/2009,8/12/2009,9/16/2009,35,0,35
8/13/2009,8/13/2009,10/13/2009,61,0,61
8/13/2009,8/13/2009,8/24/2009,11,0,11
8/13/2009,8/13/2009,9/17/2009,35,0,35
8/13/2009,8/13/2009,8/21/2009,8,0,8
8/14/2009,8/14/2009,10/14/2009,61,0,61
8/14/2009,8/14/2009,9/14/2009,31,0,31
8/14/2009,8/14/2009,9/17/2009,34,0,34
8/14/2009,8/14/2009,8/17/2009,3,0,3
8/17/2009,8/17/2009,8/24/2009,7,0,7
8/17/2009,8/17/2009,9/16/2009,30,0,30
8/17/2009,8/17/2009,9/16/2009,30,0,30
8/17/2009,8/17/2009,9/1/2009,15,0,15
8/17/2009,8/17/2009,9/15/2009,29,0,29
8/17/2009,8/17/2009,8/18/2009,1,0,1
8/17/2009,8/17/2009,9/18/2009,32,0,32
8/19/2009,8/19/2009,9/21/2009,33,0,33
8/19/2009,8/19/2009,8/20/2009,1,0,1
8/19/2009,8/19/2009,9/22/2009,34,0,34
8/20/2009,8/20/2009,8/28/2009,8,0,8
8/20/2009,8/20/2009,8/28/2009,8,0,8
8/21/2009,8/21/2009,9/10/2009,20,0,20
8/21/2009,8/21/2009,9/24/2009,34,0,34
8/25/2009,8/25/2009,10/26/2009,62,0,62
8/25/2009,8/25/2009,10/26/2009,62,0,62
8/26/2009,8/26/2009,9/29/2009,34,0,34
8/26/2009,8/26/2009,9/30/2009,35,0,35
8/26/2009,8/26/2009,9/30/2009,35,0,35
8/26/2009,8/26/2009,10/26/2009,61,0,61
8/27/2009,8/27/2009,8/28/2009,1,0,1
8/27/2009,8/27/2009,9/23/2009,27,0,27
8/27/2009,8/27/2009,10/2/2009,36,0,36
8/31/2009,8/31/2009,9/1/2009,1,0,1
9/1/2009,9/1/2009,11/3/2009,63,0,63
9/1/2009,9/1/2009,10/5/2009,34,0,34
9/1/2009,9/1/2009,9/2/2009,1,0,1
9/2/2009,9/2/2009,9/3/2009,1,0,1
9/2/2009,9/2/2009,9/11/2009,9,0,9
9/3/2009,9/3/2009,9/11/2009,8,0,8
9/3/2009,9/3/2009,10/7/2009,34,0,34
9/3/2009,9/3/2009,10/5/2009,32,0,32
9/3/2009,9/3/2009,9/11/2009,8,0,8
9/7/2009,9/7/2009,9/8/2009,1,0,1
9/7/2009,9/7/2009,10/5/2009,28,0,28
9/8/2009,9/8/2009,9/23/2009,15,0,15
9/8/2009,9/8/2009,10/26/2009,48,0,48
9/8/2009,9/8/2009,11/16/2009,69,0,69
9/8/2009,9/8/2009,10/12/2009,34,0,34
9/9/2009,9/9/2009,11/6/2009,58,0,58
9/9/2009,9/9/2009,12/7/2009,89,0,89
9/9/2009,9/9/2009,10/5/2009,26,0,26
9/9/2009,9/9/2009,9/10/2009,1,0,1
9/9/2009,9/9/2009,9/18/2009,9,0,9
9/11/2009,9/11/2009,9/14/2009,3,0,3
9/11/2009,9/11/2009,10/14/2009,33,0,33
9/14/2009,9/14/2009,11/6/2009,53,0,53
9/14/2009,9/14/2009,11/13/2009,60,0,60
9/14/2009,9/14/2009,10/12/2009,28,0,28
9/14/2009,9/14/2009,10/19/2009,35,0,35
9/14/2009,9/14/2009,9/15/2009,1,0,1
9/15/2009,9/15/2009,10/14/2009,29,0,29
9/15/2009,9/15/2009,9/16/2009,1,0,1
9/15/2009,9/15/2009,10/16/2009,31,0,31
9/17/2009,9/17/2009,11/17/2009,61,0,61
9/17/2009,9/17/2009,9/18/2009,1,0,1
9/17/2009,9/17/2009,9/28/2009,11,0,11
9/18/2009,9/18/2009,9/25/2009,7,0,7
9/18/2009,9/18/2009,10/19/2009,31,0,31
9/18/2009,9/18/2009,9/21/2009,3,0,3
9/21/2009,9/21/2009,12/16/2009,86,0,86
9/21/2009,9/21/2009,9/28/2009,7,0,7
9/21/2009,9/21/2009,9/22/2009,1,0,1
9/22/2009,9/22/2009,11/16/2009,55,0,55
9/22/2009,9/22/2009,10/15/2009,23,0,23
9/23/2009,9/23/2009,10/26/2009,33,0,33
9/23/2009,9/23/2009,10/26/2009,33,0,33
9/23/2009,9/23/2009,9/24/2009,1,0,1
9/24/2009,9/24/2009,10/5/2009,11,0,11
9/24/2009,9/24/2009,10/14/2009,20,0,20
9/24/2009,9/24/2009,10/26/2009,32,0,32
9/24/2009,9/24/2009,11/20/2009,57,0,57
9/24/2009,9/24/2009,9/25/2009,1,0,1
9/25/2009,9/25/2009,9/28/2009,3,0,3
9/25/2009,9/25/2009,10/30/2009,35,0,35
9/25/2009,9/25/2009,10/2/2009,7,0,7
9/28/2009,9/28/2009,10/5/2009,7,0,7
9/28/2009,9/28/2009,9/29/2009,1,0,1
9/28/2009,9/28/2009,10/30/2009,32,0,32
9/28/2009,9/28/2009,10/9/2009,11,0,11
9/28/2009,9/28/2009,10/9/2009,11,0,11
9/29/2009,9/29/2009,9/30/2009,1,0,1
9/30/2009,9/30/2009,10/1/2009,1,0,1
9/30/2009,9/30/2009,10/13/2009,13,0,13
9/30/2009,9/30/2009,11/3/2009,34,0,34
10/1/2009,10/1/2009,11/9/2009,39,0,39
10/1/2009,10/1/2009,10/15/2009,14,0,14
10/1/2009,10/1/2009,10/2/2009,1,0,1
10/1/2009,10/1/2009,10/13/2009,12,0,12
10/1/2009,10/1/2009,10/9/2009,8,0,8
10/1/2009,10/1/2009,10/9/2009,8,0,8
10/1/2009,10/1/2009,11/6/2009,36,0,36
10/2/2009,10/2/2009,11/6/2009,35,0,35
10/2/2009,10/2/2009,11/5/2009,34,0,34
10/2/2009,10/2/2009,11/3/2009,32,0,32
10/5/2009,10/5/2009,11/6/2009,32,0,32
10/5/2009,10/5/2009,11/6/2009,32,0,32
10/5/2009,10/5/2009,10/6/2009,1,0,1
10/6/2009,10/6/2009,11/10/2009,35,0,35
10/6/2009,10/6/2009,10/7/2009,1,0,1
10/7/2009,10/7/2009,10/8/2009,1,0,1
10/7/2009,10/7/2009,10/20/2009,13,0,13
10/7/2009,10/7/2009,10/20/2009,13,0,13
10/7/2009,10/7/2009,10/20/2009,13,0,13
10/7/2009,10/7/2009,10/20/2009,13,0,13
10/8/2009,10/8/2009,11/9/2009,32,0,32
10/8/2009,10/8/2009,11/12/2009,35,0,35
10/13/2009,10/13/2009,1/25/2010,104,0,104
10/8/2009,10/8/2009,10/16/2009,8,0,8
10/9/2009,10/9/2009,1/12/2010,95,0,95
10/9/2009,10/9/2009,10/12/2009,3,0,3
10/9/2009,10/9/2009,11/10/2009,32,0,32
10/12/2009,10/12/2009,11/12/2009,31,0,31
10/12/2009,10/12/2009,10/13/2009,1,0,1
10/13/2009,10/13/2009,1/13/2010,92,0,92
10/13/2009,10/13/2009,10/19/2009,6,0,6
10/13/2009,10/13/2009,10/19/2009,6,0,6
10/13/2009,10/13/2009,10/14/2009,1,0,1
10/14/2009,10/14/2009,1/12/2010,90,0,90
10/14/2009,10/14/2009,1/12/2010,90,0,90
10/14/2009,10/14/2009,1/12/2010,90,0,90
10/14/2009,10/14/2009,11/16/2009,33,0,33
10/14/2009,10/14/2009,11/16/2009,33,0,33
10/14/2009,10/14/2009,11/17/2009,34,0,34
10/14/2009,10/14/2009,10/15/2009,1,0,1
10/15/2009,10/15/2009,11/17/2009,33,0,33
10/15/2009,10/15/2009,11/17/2009,33,0,33
10/15/2009,10/15/2009,11/17/2009,33,0,33
10/15/2009,10/15/2009,11/16/2009,32,0,32
10/16/2009,10/16/2009,11/6/2009,21,0,21
10/16/2009,10/16/2009,11/18/2009,33,0,33
10/16/2009,10/16/2009,10/23/2009,7,0,7
10/16/2009,10/16/2009,10/23/2009,7,0,7
10/16/2009,10/16/2009,10/23/2009,7,0,7
10/16/2009,10/16/2009,10/28/2009,12,0,12
10/16/2009,10/16/2009,10/19/2009,3,0,3
10/19/2009,10/19/2009,10/26/2009,7,0,7
10/19/2009,10/19/2009,10/26/2009,7,0,7
10/19/2009,10/19/2009,11/17/2009,29,0,29
10/19/2009,10/19/2009,1/11/2010,84,0,84
10/19/2009,10/19/2009,10/20/2009,1,0,1
10/19/2009,10/19/2009,11/17/2009,29,0,29
10/20/2009,10/20/2009,10/28/2009,8,0,8
10/20/2009,10/20/2009,10/28/2009,8,0,8
10/20/2009,10/20/2009,10/21/2009,1,0,1
10/21/2009,10/21/2009,10/22/2009,1,0,1
10/22/2009,10/22/2009,10/23/2009,1,0,1
10/23/2009,10/23/2009,10/30/2009,7,0,7
10/23/2009,10/23/2009,10/26/2009,3,0,3
10/23/2009,10/23/2009,11/3/2009,11,0,11
10/26/2009,10/26/2009,1/25/2010,91,0,91
10/26/2009,10/26/2009,1/25/2010,91,0,91
10/26/2009,10/26/2009,1/25/2010,91,0,91
10/26/2009,10/26/2009,1/13/2010,79,0,79
10/26/2009,10/26/2009,11/9/2009,14,0,14
10/26/2009,10/26/2009,11/20/2009,25,0,25
10/26/2009,10/26/2009,11/23/2009,28,0,28
10/27/2009,10/27/2009,10/28/2009,1,0,1
10/27/2009,10/27/2009,11/5/2009,9,0,9
10/27/2009,10/27/2009,11/5/2009,9,0,9
10/27/2009,10/27/2009,11/5/2009,9,0,9
10/28/2009,10/28/2009,10/29/2009,1,0,1
10/28/2009,10/28/2009,11/27/2009,30,0,30
10/28/2009,10/28/2009,11/30/2009,33,0,33
10/29/2009,10/29/2009,10/30/2009,1,0,1
10/30/2009,10/30/2009,11/2/2009,3,0,3
10/30/2009,10/30/2009,11/6/2009,7,0,7
10/30/2009,10/30/2009,11/6/2009,7,0,7
10/30/2009,10/30/2009,11/10/2009,11,0,11
11/3/2009,11/3/2009,12/7/2009,34,0,34
11/3/2009,11/3/2009,11/10/2009,7,0,7
11/3/2009,11/3/2009,12/9/2009,36,0,36
11/3/2009,11/3/2009,1/7/2010,65,0,65
11/3/2009,11/3/2009,11/4/2009,1,0,1
11/3/2009,11/3/2009,11/13/2009,10,0,10
11/4/2009,11/4/2009,11/5/2009,1,0,1
11/4/2009,11/4/2009,12/7/2009,33,0,33
11/4/2009,11/4/2009,12/7/2009,33,0,33
11/5/2009,11/5/2009,11/13/2009,8,0,8
11/5/2009,11/5/2009,11/13/2009,8,0,8
11/5/2009,11/5/2009,11/13/2009,8,0,8
11/5/2009,11/5/2009,12/7/2009,32,0,32
11/5/2009,11/5/2009,11/16/2009,11,0,11
11/5/2009,11/5/2009,11/6/2009,1,0,1
11/5/2009,11/5/2009,11/6/2009,1,0,1
11/5/2009,11/5/2009,11/6/2009,1,0,1
11/5/2009,11/5/2009,11/6/2009,1,0,1
11/6/2009,11/6/2009,11/18/2009,12,0,12
11/6/2009,11/6/2009,12/7/2009,31,0,31
11/6/2009,11/6/2009,1/8/2010,63,0,63
11/6/2009,11/6/2009,12/9/2009,33,0,33
11/6/2009,11/6/2009,11/16/2009,10,0,10
11/6/2009,11/6/2009,11/16/2009,10,0,10
11/6/2009,11/6/2009,11/9/2009,3,0,3
11/6/2009,11/6/2009,11/16/2009,10,0,10
11/6/2009,11/6/2009,12/10/2009,34,0,34
11/9/2009,11/9/2009,12/9/2009,30,0,30
11/9/2009,11/9/2009,12/9/2009,30,0,30
11/10/2009,11/10/2009,11/16/2009,6,0,6
11/10/2009,11/10/2009,1/8/2010,59,0,59
11/10/2009,11/10/2009,11/16/2009,6,0,6
11/10/2009,11/10/2009,11/19/2009,9,0,9
11/10/2009,11/10/2009,12/10/2009,30,0,30
11/10/2009,11/10/2009,12/14/2009,34,0,34
11/12/2009,11/12/2009,11/13/2009,1,0,1
11/12/2009,11/12/2009,12/16/2009,34,0,34
11/12/2009,11/12/2009,12/14/2009,32,0,32
11/12/2009,11/12/2009,12/14/2009,32,0,32
11/12/2009,11/12/2009,11/23/2009,11,0,11
11/13/2009,11/13/2009,11/16/2009,3,0,3
11/13/2009,11/13/2009,12/17/2009,34,0,34
11/16/2009,11/16/2009,1/15/2010,60,0,60
11/16/2009,11/16/2009,12/14/2009,28,0,28
11/16/2009,11/16/2009,12/14/2009,28,0,28
11/16/2009,11/16/2009,12/18/2009,32,0,32
11/16/2009,11/16/2009,12/18/2009,32,0,32
11/16/2009,11/16/2009,11/30/2009,14,0,14
11/16/2009,11/16/2009,11/17/2009,1,0,1
11/16/2009,11/16/2009,12/17/2009,31,0,31
11/16/2009,11/16/2009,12/17/2009,31,0,31
11/16/2009,11/16/2009,12/15/2009,29,0,29
11/16/2009,11/16/2009,1/15/2010,60,0,60
11/16/2009,11/16/2009,12/16/2009,30,0,30
11/17/2009,11/17/2009,11/18/2009,1,0,1
11/18/2009,11/18/2009,12/16/2009,28,0,28
11/18/2009,11/18/2009,12/16/2009,28,0,28
11/19/2009,11/19/2009,11/25/2009,6,0,6
11/19/2009,11/19/2009,11/30/2009,11,0,11
11/20/2009,11/20/2009,1/25/2010,66,0,66
11/20/2009,11/20/2009,12/22/2009,32,0,32
11/20/2009,11/20/2009,11/30/2009,10,0,10
11/20/2009,11/20/2009,11/30/2009,10,0,10
11/23/2009,11/23/2009,11/30/2009,7,0,7
11/23/2009,11/23/2009,11/30/2009,7,0,7
11/23/2009,11/23/2009,12/21/2009,28,0,28
11/23/2009,11/23/2009,11/24/2009,1,0,1
11/24/2009,11/24/2009,11/25/2009,1,0,1
11/25/2009,11/25/2009,12/3/2009,8,0,8
11/26/2009,11/26/2009,11/27/2009,1,0,1
11/27/2009,11/27/2009,11/30/2009,3,0,3
11/30/2009,11/30/2009,12/31/2009,31,0,31
11/30/2009,11/30/2009,12/7/2009,7,0,7
11/30/2009,11/30/2009,12/4/2009,4,0,4
11/30/2009,11/30/2009,12/4/2009,4,0,4
11/30/2009,11/30/2009,12/4/2009,4,0,4
11/30/2009,11/30/2009,12/14/2009,14,0,14
11/30/2009,11/30/2009,12/7/2009,7,0,7
11/30/2009,11/30/2009,12/7/2009,7,0,7
11/30/2009,11/30/2009,12/1/2009,1,0,1
11/30/2009,11/30/2009,12/30/2009,30,0,30
12/1/2009,12/1/2009,12/2/2009,1,0,1
12/3/2009,12/3/2009,12/14/2009,11,0,11
12/3/2009,12/3/2009,12/14/2009,11,0,11
12/3/2009,12/3/2009,12/4/2009,1,0,1
12/3/2009,12/3/2009,1/8/2010,36,0,36
12/3/2009,12/3/2009,1/8/2010,36,0,36
12/3/2009,12/3/2009,2/22/2010,81,0,81
12/3/2009,12/3/2009,2/22/2010,81,0,81
12/3/2009,12/3/2009,1/20/2010,48,0,48
12/4/2009,12/4/2009,1/8/2010,35,0,35
12/4/2009,12/4/2009,1/8/2010,35,0,35
12/7/2009,12/7/2009,1/7/2010,31,0,31
12/7/2009,12/7/2009,12/14/2009,7,0,7
12/7/2009,12/7/2009,1/13/2010,37,0,37
12/7/2009,12/7/2009,12/8/2009,1,0,1
12/8/2009,12/8/2009,12/9/2009,1,0,1
12/8/2009,12/8/2009,1/13/2010,36,0,36
12/9/2009,12/9/2009,1/12/2010,34,0,34
12/9/2009,12/9/2009,1/12/2010,34,0,34
12/10/2009,12/10/2009,1/14/2010,35,0,35
12/10/2009,12/10/2009,12/18/2009,8,0,8
12/10/2009,12/10/2009,12/18/2009,8,0,8
12/11/2009,12/11/2009,12/14/2009,3,0,3
12/14/2009,12/14/2009,1/15/2010,32,0,32
12/14/2009,12/14/2009,12/21/2009,7,0,7
12/14/2009,12/14/2009,1/15/2010,32,0,32
12/14/2009,12/14/2009,12/21/2009,7,0,7
12/14/2009,12/14/2009,12/21/2009,7,0,7
12/14/2009,12/14/2009,1/13/2010,30,0,30
12/14/2009,12/14/2009,1/13/2010,30,0,30
12/14/2009,12/14/2009,1/13/2010,30,0,30
12/14/2009,12/14/2009,12/29/2009,15,0,15
12/15/2009,12/15/2009,12/22/2009,7,0,7
12/15/2009,12/15/2009,1/18/2010,34,0,34
12/15/2009,12/15/2009,1/18/2010,34,0,34
12/16/2009,12/16/2009,1/15/2010,30,0,30
12/17/2009,12/17/2009,1/19/2010,33,0,33
12/17/2009,12/17/2009,1/19/2010,33,0,33
12/17/2009,12/17/2009,12/18/2009,1,0,1
12/17/2009,12/17/2009,12/29/2009,12,0,12
12/18/2009,12/18/2009,1/15/2010,28,0,28
12/18/2009,12/18/2009,1/15/2010,28,0,28
12/18/2009,12/18/2009,12/29/2009,11,0,11
12/18/2009,12/18/2009,12/29/2009,11,0,11
12/18/2009,12/18/2009,1/8/2010,21,0,21
12/18/2009,12/18/2009,12/21/2009,3,0,3
12/21/2009,12/21/2009,12/29/2009,8,0,8
12/21/2009,12/21/2009,12/29/2009,8,0,8
12/21/2009,12/21/2009,12/29/2009,8,0,8
12/21/2009,12/21/2009,1/20/2010,30,0,30
12/21/2009,12/21/2009,12/22/2009,1,0,1
12/22/2009,12/22/2009,1/25/2010,34,0,34
12/22/2009,12/22/2009,1/25/2010,34,0,34
12/22/2009,12/22/2009,1/15/2010,24,0,24
12/22/2009,12/22/2009,12/23/2009,1,0,1
12/23/2009,12/23/2009,12/30/2009,7,0,7
12/24/2009,12/24/2009,12/28/2009,4,0,4
12/28/2009,12/28/2009,12/30/2009,2,0,2
12/28/2009,12/28/2009,12/29/2009,1,0,1
12/28/2009,12/28/2009,12/30/2009,2,0,2
12/28/2009,12/28/2009,1/29/2010,32,0,32
12/29/2009,12/29/2009,1/5/2010,7,0,7
12/29/2009,12/29/2009,1/5/2010,7,0,7
12/29/2009,12/29/2009,1/5/2010,7,0,7
12/29/2009,12/29/2009,1/7/2010,9,0,9
12/29/2009,12/29/2009,1/7/2010,9,0,9
12/29/2009,12/29/2009,1/14/2010,16,0,16
12/29/2009,12/29/2009,12/30/2009,1,0,1
12/29/2009,12/29/2009,1/29/2010,31,0,31
12/29/2009,12/29/2009,1/7/2010,9,0,9
12/30/2009,12/30/2009,12/31/2009,1,0,1
12/31/2009,12/31/2009,2/8/2010,39,0,39
12/31/2009,12/31/2009,1/4/2010,4,0,4
1/4/2010,1/4/2010,4/8/2010,94,0,94
1/4/2010,1/4/2010,2/3/2010,30,0,30
1/4/2010,1/4/2010,3/5/2010,60,0,60
1/4/2010,1/4/2010,1/5/2010,1,0,1
1/5/2010,1/5/2010,1/8/2010,3,0,3
1/5/2010,1/5/2010,1/8/2010,3,0,3
1/5/2010,1/5/2010,1/6/2010,1,0,1
1/5/2010,1/5/2010,1/13/2010,8,0,8
1/5/2010,1/5/2010,1/13/2010,8,0,8
1/6/2010,1/6/2010,1/7/2010,1,0,1
1/6/2010,1/6/2010,2/5/2010,30,0,30
1/6/2010,1/6/2010,2/5/2010,30,0,30
1/6/2010,1/6/2010,2/5/2010,30,0,30
1/6/2010,1/6/2010,1/13/2010,7,0,7
1/6/2010,1/6/2010,1/13/2010,7,0,7
1/6/2010,1/6/2010,4/8/2010,92,0,92
1/6/2010,1/6/2010,2/8/2010,33,0,33
1/6/2010,1/6/2010,2/5/2010,30,0,30
1/7/2010,1/7/2010,1/8/2010,1,0,1
1/8/2010,1/8/2010,4/8/2010,90,0,90
1/8/2010,1/8/2010,4/12/2010,94,0,94
1/8/2010,1/8/2010,1/15/2010,7,0,7
1/8/2010,1/8/2010,1/15/2010,7,0,7
1/8/2010,1/8/2010,1/15/2010,7,0,7
1/8/2010,1/8/2010,1/11/2010,3,0,3
1/11/2010,1/11/2010,2/10/2010,30,0,30
1/11/2010,1/11/2010,2/8/2010,28,0,28
1/12/2010,1/12/2010,4/12/2010,90,0,90
1/12/2010,1/12/2010,2/8/2010,27,0,27
1/12/2010,1/12/2010,4/13/2010,91,0,91
1/12/2010,1/12/2010,1/25/2010,13,0,13
1/12/2010,1/12/2010,2/12/2010,31,0,31
1/12/2010,1/12/2010,1/13/2010,1,0,1
1/13/2010,1/13/2010,4/13/2010,90,0,90
1/13/2010,1/13/2010,4/13/2010,90,0,90
1/13/2010,1/13/2010,4/13/2010,90,0,90
1/13/2010,1/13/2010,2/12/2010,30,0,30
1/13/2010,1/13/2010,2/9/2010,27,0,27
1/13/2010,1/13/2010,1/20/2010,7,0,7
1/13/2010,1/13/2010,1/20/2010,7,0,7
1/13/2010,1/13/2010,1/14/2010,1,0,1
1/13/2010,1/13/2010,2/16/2010,34,0,34
1/13/2010,1/13/2010,2/17/2010,35,0,35
1/14/2010,1/14/2010,2/15/2010,32,0,32
1/14/2010,1/14/2010,2/17/2010,34,0,34
1/15/2010,1/15/2010,2/12/2010,28,0,28
1/15/2010,1/15/2010,2/12/2010,28,0,28
1/15/2010,1/15/2010,1/22/2010,7,0,7
1/15/2010,1/15/2010,1/22/2010,7,0,7
1/15/2010,1/15/2010,4/15/2010,90,0,90
1/15/2010,1/15/2010,2/5/2010,21,0,21
1/15/2010,1/15/2010,3/12/2010,56,0,56
1/18/2010,1/18/2010,1/19/2010,1,0,1
1/19/2010,1/19/2010,3/17/2010,57,0,57
1/19/2010,1/19/2010,2/17/2010,29,0,29
1/19/2010,1/19/2010,2/17/2010,29,0,29
1/20/2010,1/20/2010,2/17/2010,28,0,28
1/20/2010,1/20/2010,1/27/2010,7,0,7
1/20/2010,1/20/2010,1/21/2010,1,0,1
1/20/2010,1/20/2010,2/22/2010,33,0,33
1/21/2010,1/21/2010,1/29/2010,8,0,8
1/21/2010,1/21/2010,1/22/2010,1,0,1
1/22/2010,1/22/2010,1/25/2010,3,0,3
1/22/2010,1/22/2010,1/29/2010,7,0,7
1/22/2010,1/22/2010,1/29/2010,7,0,7
1/25/2010,1/25/2010,4/23/2010,88,0,88
1/25/2010,1/25/2010,4/23/2010,88,0,88
1/25/2010,1/25/2010,4/23/2010,88,0,88
1/25/2010,1/25/2010,3/24/2010,58,0,58
1/25/2010,1/25/2010,2/22/2010,28,0,28
1/26/2010,1/26/2010,1/27/2010,1,0,1
1/27/2010,1/27/2010,2/26/2010,30,0,30
1/27/2010,1/27/2010,2/3/2010,7,0,7
1/27/2010,1/27/2010,2/26/2010,30,0,30
1/28/2010,1/28/2010,1/29/2010,1,0,1
1/29/2010,1/29/2010,2/5/2010,7,0,7
1/29/2010,1/29/2010,2/5/2010,7,0,7
1/29/2010,1/29/2010,2/5/2010,7,0,7
2/1/2010,2/1/2010,2/2/2010,1,0,1
2/1/2010,2/1/2010,3/4/2010,31,0,31
2/3/2010,2/3/2010,2/4/2010,1,0,1
2/3/2010,2/3/2010,3/5/2010,30,0,30
2/3/2010,2/3/2010,3/5/2010,30,0,30
2/5/2010,2/5/2010,3/9/2010,32,0,32
2/5/2010,2/5/2010,2/19/2010,14,0,14
2/5/2010,2/5/2010,3/9/2010,32,0,32
2/5/2010,2/5/2010,2/12/2010,7,0,7
2/5/2010,2/5/2010,3/9/2010,32,0,32
2/5/2010,2/5/2010,3/12/2010,35,0,35
2/8/2010,2/8/2010,3/8/2010,28,0,28
2/8/2010,2/8/2010,3/8/2010,28,0,28
2/8/2010,2/8/2010,3/8/2010,28,0,28
2/8/2010,2/8/2010,2/22/2010,14,0,14
2/8/2010,2/8/2010,2/9/2010,1,0,1
2/9/2010,2/9/2010,2/18/2010,9,0,9
2/9/2010,2/9/2010,2/10/2010,1,0,1
2/10/2010,2/10/2010,2/18/2010,8,0,8
2/10/2010,2/10/2010,2/18/2010,8,0,8
2/10/2010,2/10/2010,3/12/2010,30,0,30
2/10/2010,2/10/2010,3/15/2010,33,0,33
2/11/2010,2/11/2010,2/12/2010,1,0,1
2/11/2010,2/11/2010,3/12/2010,29,0,29
2/11/2010,2/11/2010,4/16/2010,64,0,64
2/11/2010,2/11/2010,3/16/2010,33,0,33
2/11/2010,2/11/2010,2/19/2010,8,0,8
2/11/2010,2/11/2010,3/24/2010,41,0,41
2/15/2010,2/15/2010,3/12/2010,25,0,25
2/15/2010,2/15/2010,2/16/2010,1,0,1
2/17/2010,2/17/2010,2/19/2010,2,0,2
2/17/2010,2/17/2010,2/19/2010,2,0,2
2/12/2010,2/12/2010,2/19/2010,7,0,7
2/12/2010,2/12/2010,2/19/2010,7,0,7
2/12/2010,2/12/2010,2/19/2010,7,0,7
2/12/2010,2/12/2010,3/12/2010,28,0,28
2/12/2010,2/12/2010,3/16/2010,32,0,32
2/15/2010,2/15/2010,3/17/2010,30,0,30
2/16/2010,2/16/2010,2/17/2010,1,0,1
2/17/2010,2/17/2010,3/16/2010,27,0,27
2/17/2010,2/17/2010,3/17/2010,28,0,28
2/17/2010,2/17/2010,2/26/2010,9,0,9
2/17/2010,2/17/2010,3/17/2010,28,0,28
2/17/2010,2/17/2010,3/17/2010,28,0,28
2/18/2010,2/18/2010,2/26/2010,8,0,8
2/18/2010,2/18/2010,2/24/2010,6,0,6
2/18/2010,2/18/2010,2/19/2010,1,0,1
2/19/2010,2/19/2010,2/26/2010,7,0,7
2/19/2010,2/19/2010,3/22/2010,31,0,31
2/19/2010,2/19/2010,2/22/2010,3,0,3
2/19/2010,2/19/2010,2/26/2010,7,0,7
2/22/2010,2/22/2010,3/24/2010,30,0,30
2/22/2010,2/22/2010,3/24/2010,30,0,30
2/22/2010,2/22/2010,3/24/2010,30,0,30
2/22/2010,2/22/2010,3/22/2010,28,0,28
2/22/2010,2/22/2010,3/15/2010,21,0,21
2/22/2010,2/22/2010,3/22/2010,28,0,28
2/22/2010,2/22/2010,2/23/2010,1,0,1
2/22/2010,2/22/2010,3/3/2010,9,0,9
2/24/2010,2/24/2010,3/3/2010,7,0,7
2/24/2010,2/24/2010,2/25/2010,1,0,1
2/25/2010,2/25/2010,2/26/2010,1,0,1
2/25/2010,2/25/2010,3/31/2010,34,0,34
2/25/2010,2/25/2010,3/5/2010,8,0,8
2/25/2010,2/25/2010,3/5/2010,8,0,8
2/25/2010,2/25/2010,3/5/2010,8,0,8
2/25/2010,2/25/2010,3/5/2010,8,0,8
2/25/2010,2/25/2010,3/5/2010,8,0,8
2/26/2010,2/26/2010,3/1/2010,3,0,3
3/2/2010,3/2/2010,3/29/2010,27,0,27
3/2/2010,3/2/2010,4/1/2010,30,0,30
3/3/2010,3/3/2010,4/9/2010,37,0,37
3/3/2010,3/3/2010,4/9/2010,37,0,37
3/4/2010,3/4/2010,3/12/2010,8,0,8
3/5/2010,3/5/2010,5/7/2010,63,0,63
3/5/2010,3/5/2010,5/7/2010,63,0,63
3/5/2010,3/5/2010,3/12/2010,7,0,7
3/5/2010,3/5/2010,3/12/2010,7,0,7
3/5/2010,3/5/2010,3/12/2010,7,0,7
3/5/2010,3/5/2010,3/12/2010,7,0,7
3/5/2010,3/5/2010,3/12/2010,7,0,7
3/5/2010,3/5/2010,3/8/2010,3,0,3
3/8/2010,3/8/2010,4/12/2010,35,0,35
3/8/2010,3/8/2010,4/12/2010,35,0,35
3/8/2010,3/8/2010,3/31/2010,23,0,23
3/8/2010,3/8/2010,3/31/2010,23,0,23
3/8/2010,3/8/2010,3/9/2010,1,0,1
3/8/2010,3/8/2010,4/13/2010,36,0,36
3/8/2010,3/8/2010,3/17/2010,9,0,9
3/8/2010,3/8/2010,4/13/2010,36,0,36
3/8/2010,3/8/2010,4/13/2010,36,0,36
3/9/2010,3/9/2010,3/10/2010,1,0,1
3/10/2010,3/10/2010,3/17/2010,7,0,7
3/10/2010,3/10/2010,3/11/2010,1,0,1
3/10/2010,3/10/2010,3/22/2010,12,0,12
3/10/2010,3/10/2010,4/15/2010,36,0,36
3/11/2010,3/11/2010,3/12/2010,1,0,1
3/11/2010,3/11/2010,4/14/2010,34,0,34
3/11/2010,3/11/2010,3/22/2010,11,0,11
3/12/2010,3/12/2010,3/22/2010,10,0,10
3/12/2010,3/12/2010,3/22/2010,10,0,10
3/12/2010,3/12/2010,4/20/2010,39,0,39
3/12/2010,3/12/2010,3/19/2010,7,0,7
3/12/2010,3/12/2010,3/19/2010,7,0,7
3/12/2010,3/12/2010,4/16/2010,35,0,35
3/12/2010,3/12/2010,4/16/2010,35,0,35
3/12/2010,3/12/2010,4/16/2010,35,0,35
3/12/2010,3/12/2010,4/8/2010,27,0,27
3/12/2010,3/12/2010,3/15/2010,3,0,3
3/12/2010,3/12/2010,4/16/2010,35,0,35
3/15/2010,3/15/2010,4/19/2010,35,0,35
3/15/2010,3/15/2010,5/18/2010,64,0,64
3/15/2010,3/15/2010,3/16/2010,1,0,1
3/15/2010,3/15/2010,3/26/2010,11,0,11
3/15/2010,3/15/2010,4/19/2010,35,0,35
3/15/2010,3/15/2010,4/19/2010,35,0,35
3/15/2010,3/15/2010,4/14/2010,30,0,30
3/16/2010,3/16/2010,3/17/2010,1,0,1
3/16/2010,3/16/2010,4/20/2010,35,0,35
3/16/2010,3/16/2010,4/20/2010,35,0,35
3/16/2010,3/16/2010,4/20/2010,35,0,35
3/17/2010,3/17/2010,5/17/2010,61,0,61
3/17/2010,3/17/2010,4/19/2010,33,0,33
3/17/2010,3/17/2010,3/26/2010,9,0,9
3/18/2010,3/18/2010,3/19/2010,1,0,1
3/19/2010,3/19/2010,3/26/2010,7,0,7
3/19/2010,3/19/2010,3/26/2010,7,0,7
3/19/2010,3/19/2010,3/26/2010,7,0,7
3/19/2010,3/19/2010,3/22/2010,3,0,3
3/19/2010,3/19/2010,4/20/2010,32,0,32
3/22/2010,3/22/2010,3/29/2010,7,0,7
3/22/2010,3/22/2010,3/23/2010,1,0,1
3/22/2010,3/22/2010,4/22/2010,31,0,31
3/24/2010,3/24/2010,4/20/2010,27,0,27
3/25/2010,3/25/2010,3/26/2010,1,0,1
3/26/2010,3/26/2010,4/6/2010,11,0,11
3/26/2010,3/26/2010,4/6/2010,11,0,11
3/26/2010,3/26/2010,4/7/2010,12,0,12
3/26/2010,3/26/2010,4/7/2010,12,0,12
3/26/2010,3/26/2010,4/7/2010,12,0,12
3/26/2010,3/26/2010,3/29/2010,3,0,3
3/26/2010,3/26/2010,4/8/2010,13,0,13
3/26/2010,3/26/2010,4/29/2010,34,0,34
3/29/2010,3/29/2010,4/8/2010,10,0,10
3/29/2010,3/29/2010,4/8/2010,10,0,10
3/29/2010,3/29/2010,4/29/2010,31,0,31
3/29/2010,3/29/2010,4/12/2010,14,0,14
3/30/2010,3/30/2010,3/31/2010,1,0,1
3/31/2010,3/31/2010,5/10/2010,40,0,40
3/31/2010,3/31/2010,4/1/2010,1,0,1
4/1/2010,4/1/2010,4/6/2010,5,0,5
4/2/2010,4/2/2010,4/9/2010,7,0,7
4/2/2010,4/2/2010,4/9/2010,7,0,7
4/2/2010,4/2/2010,4/9/2010,7,0,7
4/6/2010,4/6/2010,4/15/2010,9,0,9
4/6/2010,4/6/2010,5/7/2010,31,0,31
4/6/2010,4/6/2010,4/15/2010,9,0,9
4/7/2010,4/7/2010,4/15/2010,8,0,8
4/8/2010,4/8/2010,5/7/2010,29,0,29
4/8/2010,4/8/2010,7/6/2010,89,0,89
4/8/2010,4/8/2010,4/9/2010,1,0,1
4/8/2010,4/8/2010,5/11/2010,33,0,33
4/8/2010,4/8/2010,5/11/2010,33,0,33
4/8/2010,4/8/2010,5/11/2010,33,0,33
4/9/2010,4/9/2010,4/16/2010,7,0,7
4/9/2010,4/9/2010,4/16/2010,7,0,7
4/9/2010,4/9/2010,4/16/2010,7,0,7
4/9/2010,4/9/2010,4/12/2010,3,0,3
4/9/2010,4/9/2010,5/10/2010,31,0,31
4/9/2010,4/9/2010,5/14/2010,35,0,35
4/12/2010,4/12/2010,5/17/2010,35,0,35
4/12/2010,4/12/2010,5/14/2010,32,0,32
4/13/2010,4/13/2010,7/13/2010,91,0,91
4/13/2010,4/13/2010,7/13/2010,91,0,91
4/13/2010,4/13/2010,5/21/2010,38,0,38
4/13/2010,4/13/2010,5/18/2010,35,0,35
4/13/2010,4/13/2010,4/14/2010,1,0,1
4/14/2010,4/14/2010,4/15/2010,1,0,1
4/14/2010,4/14/2010,5/17/2010,33,0,33
4/14/2010,4/14/2010,4/22/2010,8,0,8
4/14/2010,4/14/2010,4/22/2010,8,0,8
4/14/2010,4/14/2010,4/22/2010,8,0,8
4/14/2010,4/14/2010,4/22/2010,8,0,8
4/15/2010,4/15/2010,5/17/2010,32,0,32
4/15/2010,4/15/2010,5/17/2010,32,0,32
4/15/2010,4/15/2010,5/17/2010,32,0,32
4/15/2010,4/15/2010,7/15/2010,91,0,91
4/15/2010,4/15/2010,5/17/2010,32,0,32
4/15/2010,4/15/2010,5/17/2010,32,0,32
4/15/2010,4/15/2010,4/23/2010,8,0,8
4/16/2010,4/16/2010,5/20/2010,34,0,34
4/16/2010,4/16/2010,5/18/2010,32,0,32
4/16/2010,4/16/2010,5/17/2010,31,0,31
4/20/2010,4/20/2010,5/20/2010,30,0,30
4/20/2010,4/20/2010,5/25/2010,35,0,35
4/20/2010,4/20/2010,5/25/2010,35,0,35
4/21/2010,4/21/2010,4/27/2010,6,0,6
4/21/2010,4/21/2010,4/27/2010,6,0,6
4/22/2010,4/22/2010,4/29/2010,7,0,7
4/22/2010,4/22/2010,4/29/2010,7,0,7
4/22/2010,4/22/2010,4/29/2010,7,0,7
4/23/2010,4/23/2010,7/26/2010,94,0,94
4/23/2010,4/23/2010,7/26/2010,94,0,94
4/23/2010,4/23/2010,5/17/2010,24,0,24
4/23/2010,4/23/2010,5/10/2010,17,0,17
4/23/2010,4/23/2010,5/21/2010,28,0,28
4/23/2010,4/23/2010,4/30/2010,7,0,7
4/23/2010,4/23/2010,4/30/2010,7,0,7
4/23/2010,4/23/2010,4/30/2010,7,0,7
4/23/2010,4/23/2010,5/21/2010,28,0,28
4/23/2010,4/23/2010,5/21/2010,28,0,28
4/23/2010,4/23/2010,7/26/2010,94,0,94
4/26/2010,4/26/2010,5/6/2010,10,0,10
4/26/2010,4/26/2010,5/6/2010,10,0,10
4/27/2010,4/27/2010,5/28/2010,31,0,31
4/27/2010,4/27/2010,5/28/2010,31,0,31
4/29/2010,4/29/2010,5/7/2010,8,0,8
4/29/2010,4/29/2010,5/28/2010,29,0,29
4/29/2010,4/29/2010,5/7/2010,8,0,8
4/29/2010,4/29/2010,5/7/2010,8,0,8
4/29/2010,4/29/2010,5/28/2010,29,0,29
5/4/2010,5/4/2010,6/4/2010,31,0,31
5/4/2010,5/4/2010,5/12/2010,8,0,8
5/4/2010,5/4/2010,5/12/2010,8,0,8
5/5/2010,5/5/2010,6/7/2010,33,0,33
5/5/2010,5/5/2010,5/17/2010,12,0,12
5/5/2010,5/5/2010,5/17/2010,12,0,12
5/6/2010,5/6/2010,6/10/2010,35,0,35
5/6/2010,5/6/2010,6/9/2010,34,0,34
5/7/2010,5/7/2010,8/9/2010,94,0,94
5/6/2010,5/6/2010,6/21/2010,46,0,46
5/6/2010,5/6/2010,5/17/2010,11,0,11
5/6/2010,5/6/2010,5/17/2010,11,0,11
5/6/2010,5/6/2010,6/7/2010,32,0,32
5/7/2010,5/7/2010,5/17/2010,10,0,10
5/7/2010,5/7/2010,6/9/2010,33,0,33
5/7/2010,5/7/2010,7/12/2010,66,0,66
5/7/2010,5/7/2010,6/9/2010,33,0,33
5/10/2010,5/10/2010,6/7/2010,28,0,28
5/10/2010,5/10/2010,6/7/2010,28,0,28
5/11/2010,5/11/2010,6/9/2010,29,0,29
5/11/2010,5/11/2010,6/10/2010,30,0,30
5/12/2010,5/12/2010,5/19/2010,7,0,7
5/12/2010,5/12/2010,5/19/2010,7,0,7
5/12/2010,5/12/2010,6/14/2010,33,0,33
5/12/2010,5/12/2010,6/17/2010,36,0,36
5/12/2010,5/12/2010,6/17/2010,36,0,36
5/17/2010,5/12/2010,6/17/2010,36,-5,31
5/12/2010,5/12/2010,6/14/2010,33,0,33
5/12/2010,5/12/2010,6/14/2010,33,0,33
5/17/2010,5/12/2010,6/14/2010,33,-5,28
5/17/2010,5/12/2010,5/21/2010,9,-5,4
5/14/2010,5/14/2010,6/16/2010,33,0,33
5/17/2010,5/17/2010,5/21/2010,4,0,4
5/17/2010,5/17/2010,5/21/2010,4,0,4
5/17/2010,5/17/2010,5/19/2010,2,0,2
5/17/2010,5/17/2010,5/19/2010,2,0,2
5/17/2010,5/17/2010,6/14/2010,28,0,28
5/17/2010,5/17/2010,6/14/2010,28,0,28
5/17/2010,5/17/2010,6/14/2010,28,0,28
5/17/2010,5/17/2010,6/14/2010,28,0,28
5/17/2010,5/17/2010,6/17/2010,31,0,31
5/17/2010,5/17/2010,6/15/2010,29,0,29
5/17/2010,5/17/2010,6/15/2010,29,0,29
5/19/2010,5/18/2010,6/21/2010,34,-1,33
5/18/2010,5/18/2010,5/21/2010,3,0,3
5/19/2010,5/19/2010,5/28/2010,9,0,9
5/20/2010,5/20/2010,6/16/2010,27,0,27
5/21/2010,5/20/2010,6/16/2010,27,-1,26
5/20/2010,5/20/2010,6/23/2010,34,0,34
5/20/2010,5/20/2010,6/23/2010,34,0,34
5/20/2010,5/20/2010,6/23/2010,34,0,34
5/20/2010,5/20/2010,6/21/2010,32,0,32
5/20/2010,5/20/2010,5/28/2010,8,0,8
5/20/2010,5/20/2010,5/25/2010,5,0,5
5/21/2010,5/21/2010,6/16/2010,26,0,26
5/21/2010,5/21/2010,6/16/2010,26,0,26
5/21/2010,5/21/2010,6/2/2010,12,0,12
5/21/2010,5/21/2010,6/4/2010,14,0,14
5/27/2010,5/27/2010,6/4/2010,8,0,8
5/27/2010,5/27/2010,6/4/2010,8,0,8
5/27/2010,5/27/2010,6/28/2010,32,0,32
5/27/2010,5/27/2010,7/2/2010,36,0,36
5/27/2010,5/27/2010,6/14/2010,18,0,18
6/2/2010,6/2/2010,6/9/2010,7,0,7
6/4/2010,6/3/2010,6/14/2010,11,-1,10
6/3/2010,6/3/2010,7/7/2010,34,0,34
6/3/2010,6/3/2010,6/11/2010,8,0,8
6/3/2010,6/3/2010,6/11/2010,8,0,8
6/4/2010,6/3/2010,6/18/2010,15,-1,14
6/3/2010,6/3/2010,7/2/2010,29,0,29
6/4/2010,6/4/2010,6/14/2010,10,0,10
6/8/2010,6/8/2010,7/12/2010,34,0,34
6/9/2010,6/9/2010,7/12/2010,33,0,33
6/9/2010,6/9/2010,6/16/2010,7,0,7
6/9/2010,6/9/2010,6/16/2010,7,0,7
6/9/2010,6/9/2010,7/5/2010,26,0,26
6/11/2010,6/11/2010,6/18/2010,7,0,7
6/11/2010,6/11/2010,6/18/2010,7,0,7
6/11/2010,6/11/2010,7/9/2010,28,0,28
6/11/2010,6/11/2010,7/15/2010,34,0,34
6/11/2010,6/11/2010,6/21/2010,10,0,10
6/14/2010,6/14/2010,6/21/2010,7,0,7
6/14/2010,6/14/2010,7/13/2010,29,0,29
6/14/2010,6/14/2010,7/15/2010,31,0,31
6/14/2010,6/14/2010,7/15/2010,31,0,31
6/14/2010,6/14/2010,7/19/2010,35,0,35
6/16/2010,6/14/2010,7/20/2010,36,-2,34
6/15/2010,6/15/2010,7/16/2010,31,0,31
6/15/2010,6/15/2010,7/16/2010,31,0,31
6/15/2010,6/15/2010,2/5/2010,-130,0,-130
6/15/2010,6/15/2010,2/5/2010,-130,0,-130
6/15/2010,6/15/2010,3/5/2010,-102,0,-102
6/15/2010,6/15/2010,3/5/2010,-102,0,-102
6/15/2010,6/15/2010,4/9/2010,-67,0,-67
4/16/2010,6/15/2010,4/12/2010,-64,60,-4
6/17/2010,6/15/2010,7/19/2010,34,-2,32
6/15/2010,6/15/2010,7/19/2010,34,0,34
4/21/2010,6/15/2010,3/12/2010,-95,55,-40
6/15/2010,6/15/2010,5/7/2010,-39,0,-39
6/15/2010,6/15/2010,5/17/2010,-29,0,-29
6/15/2010,6/15/2010,5/17/2010,-29,0,-29
4/21/2010,6/15/2010,3/12/2010,-95,55,-40
5/6/2010,6/15/2010,5/12/2010,-34,40,6
4/16/2010,6/15/2010,4/12/2010,-64,60,-4
6/15/2010,6/15/2010,6/7/2010,-8,0,-8
6/15/2010,6/15/2010,6/7/2010,-8,0,-8
6/15/2010,6/15/2010,6/7/2010,-8,0,-8
4/16/2010,6/15/2010,4/12/2010,-64,60,-4
4/13/2010,6/15/2010,4/16/2010,-60,63,3
5/31/2010,6/15/2010,6/15/2010,0,15,15
5/31/2010,6/15/2010,6/15/2010,0,15,15
5/31/2010,6/15/2010,6/15/2010,0,15,15
6/15/2010,6/15/2010,3/22/2010,-85,0,-85
6/15/2010,6/15/2010,6/21/2010,6,0,6
6/16/2010,6/16/2010,7/5/2010,19,0,19
6/16/2010,6/16/2010,7/5/2010,19,0,19
6/16/2010,6/16/2010,6/21/2010,5,0,5
5/31/2010,6/16/2010,6/15/2010,-1,16,15
6/16/2010,6/16/2010,6/15/2010,-1,0,-1
6/16/2010,6/16/2010,6/15/2010,-1,0,-1
6/16/2010,6/16/2010,6/3/2010,-13,0,-13
6/16/2010,6/16/2010,5/17/2010,-30,0,-30
6/16/2010,6/16/2010,7/12/2010,26,0,26
6/16/2010,6/16/2010,7/12/2010,26,0,26
6/16/2010,6/16/2010,7/20/2010,34,0,34
6/16/2010,6/16/2010,5/3/2010,-44,0,-44
6/16/2010,6/16/2010,4/19/2010,-58,0,-58
6/16/2010,6/16/2010,5/3/2010,-44,0,-44
6/16/2010,6/16/2010,5/3/2010,-44,0,-44
6/16/2010,6/16/2010,4/6/2010,-71,0,-71
6/16/2010,6/16/2010,7/8/2010,22,0,22
6/16/2010,6/16/2010,7/15/2010,29,0,29
6/16/2010,6/16/2010,4/19/2010,-58,0,-58
6/16/2010,6/16/2010,4/19/2010,-58,0,-58
6/16/2010,6/16/2010,5/3/2010,-44,0,-44
5/31/2010,6/16/2010,6/10/2010,-6,16,10
6/16/2010,6/16/2010,5/17/2010,-30,0,-30
6/16/2010,6/16/2010,5/17/2010,-30,0,-30
5/31/2010,6/16/2010,5/17/2010,-30,16,-14
6/16/2010,6/16/2010,5/19/2010,-28,0,-28
6/16/2010,6/16/2010,5/19/2010,-28,0,-28
6/16/2010,6/16/2010,7/12/2010,26,0,26
5/31/2010,6/16/2010,5/10/2010,-37,16,-21
4/30/2010,6/16/2010,3/19/2010,-89,47,-42
6/16/2010,6/16/2010,6/15/2010,-1,0,-1
6/16/2010,6/16/2010,6/21/2010,5,0,5
6/16/2010,6/16/2010,7/5/2010,19,0,19
6/16/2010,6/16/2010,7/5/2010,19,0,19
6/16/2010,6/16/2010,7/12/2010,26,0,26
6/16/2010,6/16/2010,7/15/2010,29,0,29
6/16/2010,6/16/2010,3/15/2010,-93,0,-93
4/29/2010,6/16/2010,4/15/2010,-62,48,-14
6/16/2010,6/16/2010,6/11/2010,-5,0,-5
6/11/2010,6/16/2010,7/7/2010,21,5,26
6/17/2010,6/17/2010,7/19/2010,32,0,32
6/17/2010,6/17/2010,7/19/2010,32,0,32
6/18/2010,6/18/2010,7/19/2010,31,0,31
6/18/2010,6/18/2010,6/25/2010,7,0,7
6/18/2010,6/18/2010,6/25/2010,7,0,7
6/18/2010,6/18/2010,6/25/2010,7,0,7
6/18/2010,6/18/2010,6/22/2010,4,0,4
6/21/2010,6/21/2010,7/20/2010,29,0,29
6/21/2010,6/21/2010,7/20/2010,29,0,29
6/21/2010,6/21/2010,7/21/2010,30,0,30
6/22/2010,6/22/2010,6/25/2010,3,0,3
6/23/2010,6/23/2010,7/26/2010,33,0,33
6/21/2010,6/24/2010,7/19/2010,25,3,28
6/25/2010,6/25/2010,6/29/2010,4,0,4
6/25/2010,6/25/2010,6/29/2010,4,0,4
6/25/2010,6/25/2010,6/29/2010,4,0,4
6/28/2010,6/28/2010,7/19/2010,21,0,21
6/28/2010,6/28/2010,7/6/2010,8,0,8
6/28/2010,6/28/2010,7/6/2010,8,0,8
6/28/2010,6/28/2010,7/6/2010,8,0,8
6/28/2010,6/28/2010,7/2/2010,4,0,4
6/28/2010,6/28/2010,7/2/2010,4,0,4
6/29/2010,6/29/2010,7/1/2010,2,0,2
7/2/2010,6/30/2010,7/12/2010,12,-2,10
7/2/2010,6/30/2010,7/9/2010,9,-2,7
6/30/2010,6/30/2010,7/2/2010,2,0,2
7/2/2010,7/2/2010,7/12/2010,10,0,10
7/2/2010,7/2/2010,7/7/2010,5,0,5
7/2/2010,7/2/2010,7/7/2010,5,0,5
6/17/2010,7/2/2010,7/16/2010,14,15,29
6/17/2010,7/2/2010,7/16/2010,14,15,29
7/2/2010,7/2/2010,10/6/2010,96,0,96
7/2/2010,7/2/2010,7/13/2010,11,0,11
7/2/2010,7/2/2010,7/13/2010,11,0,11
7/2/2010,7/2/2010,7/13/2010,11,0,11
7/7/2010,7/7/2010,7/19/2010,12,0,12
7/5/2010,7/6/2010,8/3/2010,28,1,29
7/5/2010,7/6/2010,8/3/2010,28,1,29
7/6/2010,7/6/2010,8/6/2010,31,0,31
7/6/2010,7/6/2010,8/6/2010,31,0,31
7/6/2010,7/6/2010,8/6/2010,31,0,31
7/6/2010,7/6/2010,7/9/2010,3,0,3
7/9/2010,7/8/2010,8/9/2010,32,-1,31
7/8/2010,7/8/2010,10/12/2010,96,0,96
7/8/2010,7/8/2010,9/10/2010,64,0,64
7/8/2010,7/8/2010,7/13/2010,5,0,5
7/8/2010,7/8/2010,7/16/2010,8,0,8
7/8/2010,7/8/2010,7/16/2010,8,0,8
7/8/2010,7/8/2010,7/19/2010,11,0,11
7/9/2010,7/9/2010,8/10/2010,32,0,32
7/9/2010,7/9/2010,8/9/2010,31,0,31
7/9/2010,7/9/2010,9/8/2010,61,0,61
7/9/2010,7/9/2010,10/12/2010,95,0,95
7/9/2010,7/9/2010,8/11/2010,33,0,33
7/12/2010,7/9/2010,7/21/2010,12,-3,9
7/9/2010,7/9/2010,8/13/2010,35,0,35
7/9/2010,7/9/2010,8/9/2010,31,0,31
7/9/2010,7/9/2010,9/8/2010,61,0,61
7/9/2010,7/9/2010,7/20/2010,11,0,11
7/12/2010,7/12/2010,7/16/2010,4,0,4
7/12/2010,7/12/2010,7/16/2010,4,0,4
7/12/2010,7/12/2010,7/21/2010,9,0,9
7/12/2010,7/12/2010,7/21/2010,9,0,9
7/12/2010,7/12/2010,8/12/2010,31,0,31
7/12/2010,7/12/2010,10/13/2010,93,0,93
7/12/2010,7/12/2010,7/20/2010,8,0,8
7/13/2010,7/12/2010,8/13/2010,32,-1,31
7/13/2010,7/12/2010,8/13/2010,32,-1,31
7/7/2010,7/13/2010,7/14/2010,1,6,7
7/13/2010,7/13/2010,10/14/2010,93,0,93
7/13/2010,7/13/2010,10/12/2010,91,0,91
7/13/2010,7/13/2010,8/13/2010,31,0,31
7/13/2010,7/13/2010,8/13/2010,31,0,31
7/12/2010,7/16/2010,8/12/2010,27,4,31
7/16/2010,7/15/2010,8/17/2010,33,-1,32
7/16/2010,7/15/2010,8/17/2010,33,-1,32
7/16/2010,7/15/2010,7/27/2010,12,-1,11
7/16/2010,7/15/2010,8/17/2010,33,-1,32
7/15/2010,7/15/2010,8/16/2010,32,0,32
7/19/2010,7/16/2010,8/17/2010,32,-3,29
7/12/2010,7/16/2010,8/12/2010,27,4,31
7/5/2010,7/16/2010,8/3/2010,18,11,29
7/5/2010,7/16/2010,8/3/2010,18,11,29
7/5/2010,7/16/2010,8/3/2010,18,11,29
7/5/2010,7/16/2010,8/3/2010,18,11,29
7/19/2010,7/16/2010,7/28/2010,12,-3,9
7/19/2010,7/16/2010,8/20/2010,35,-3,32
7/16/2010,7/16/2010,8/17/2010,32,0,32
7/16/2010,7/16/2010,7/23/2010,7,0,7
7/16/2010,7/16/2010,7/23/2010,7,0,7
7/16/2010,7/16/2010,8/18/2010,33,0,33
7/16/2010,7/16/2010,7/27/2010,11,0,11
7/15/2010,7/19/2010,8/16/2010,28,4,32
7/15/2010,7/19/2010,8/16/2010,28,4,32
7/15/2010,7/19/2010,8/16/2010,28,4,32
7/15/2010,7/19/2010,8/16/2010,28,4,32
7/12/2010,7/22/2010,8/12/2010,21,10,31
7/8/2010,7/22/2010,8/9/2010,18,14,32
7/16/2010,7/22/2010,8/17/2010,26,6,32
7/19/2010,7/19/2010,8/20/2010,32,0,32
7/19/2010,7/19/2010,8/20/2010,32,0,32
7/19/2010,7/19/2010,7/28/2010,9,0,9
7/19/2010,7/19/2010,7/28/2010,9,0,9
7/19/2010,7/19/2010,7/27/2010,8,0,8
7/20/2010,7/20/2010,7/28/2010,8,0,8
7/20/2010,7/20/2010,7/28/2010,8,0,8
7/20/2010,7/20/2010,7/28/2010,8,0,8
7/19/2010,7/21/2010,8/19/2010,29,2,31
7/19/2010,7/21/2010,8/19/2010,29,2,31
7/12/2010,7/22/2010,8/12/2010,21,10,31
7/8/2010,7/22/2010,8/9/2010,18,14,32
7/8/2010,7/22/2010,8/9/2010,18,14,32
7/12/2010,7/22/2010,8/10/2010,19,10,29
7/16/2010,7/22/2010,8/17/2010,26,6,32
7/16/2010,7/22/2010,8/17/2010,26,6,32
6/21/2010,7/22/2010,9/20/2010,60,31,91
7/22/2010,7/22/2010,7/30/2010,8,0,8
7/22/2010,7/22/2010,7/30/2010,8,0,8
7/22/2010,7/22/2010,7/27/2010,5,0,5
7/22/2010,7/22/2010,10/25/2010,95,0,95
7/22/2010,7/22/2010,8/23/2010,32,0,32
7/23/2010,7/22/2010,8/23/2010,32,-1,31
7/23/2010,7/23/2010,8/23/2010,31,0,31
7/26/2010,7/26/2010,8/4/2010,9,0,9
7/26/2010,7/26/2010,7/30/2010,4,0,4
7/26/2010,7/26/2010,7/30/2010,4,0,4
7/29/2010,7/29/2010,8/6/2010,8,0,8
7/27/2010,7/27/2010,8/4/2010,8,0,8
7/27/2010,7/27/2010,8/4/2010,8,0,8
7/27/2010,7/27/2010,8/27/2010,31,0,31
7/27/2010,7/27/2010,8/27/2010,31,0,31
7/27/2010,7/27/2010,8/4/2010,8,0,8
7/27/2010,7/27/2010,8/4/2010,8,0,8
7/29/2010,7/29/2010,8/27/2010,29,0,29
7/30/2010,7/29/2010,8/3/2010,5,-1,4
8/3/2010,8/2/2010,8/12/2010,10,-1,9
8/2/2010,8/2/2010,8/12/2010,10,0,10
8/2/2010,8/2/2010,8/6/2010,4,0,4
8/3/2010,8/3/2010,9/3/2010,31,0,31
8/3/2010,8/3/2010,9/3/2010,31,0,31
8/3/2010,8/3/2010,9/3/2010,31,0,31
8/3/2010,8/3/2010,9/3/2010,31,0,31
8/3/2010,8/3/2010,9/3/2010,31,0,31
8/3/2010,8/3/2010,9/10/2010,38,0,38
8/3/2010,8/3/2010,8/12/2010,9,0,9
8/3/2010,8/3/2010,8/12/2010,9,0,9
8/3/2010,8/3/2010,8/11/2010,8,0,8
8/5/2010,8/4/2010,9/6/2010,33,-1,32
8/5/2010,8/4/2010,9/6/2010,33,-1,32
8/4/2010,8/4/2010,9/7/2010,34,0,34
8/4/2010,8/4/2010,9/7/2010,34,0,34
8/6/2010,8/5/2010,9/8/2010,34,-1,33
8/5/2010,8/5/2010,8/13/2010,8,0,8
8/5/2010,8/5/2010,8/13/2010,8,0,8
8/5/2010,8/5/2010,8/13/2010,8,0,8
8/5/2010,8/5/2010,9/3/2010,29,0,29
8/6/2010,8/6/2010,9/8/2010,33,0,33
8/6/2010,8/6/2010,9/3/2010,28,0,28
8/9/2010,8/9/2010,9/10/2010,32,0,32
8/9/2010,8/9/2010,9/10/2010,32,0,32
8/10/2010,8/9/2010,8/19/2010,10,-1,9
8/9/2010,8/9/2010,9/10/2010,32,0,32
8/9/2010,8/9/2010,9/7/2010,29,0,29
8/9/2010,8/9/2010,9/7/2010,29,0,29
8/9/2010,8/9/2010,9/9/2010,31,0,31
8/10/2010,8/10/2010,9/9/2010,30,0,30
8/10/2010,8/10/2010,8/19/2010,9,0,9
8/12/2010,8/10/2010,9/14/2010,35,-2,33
8/12/2010,8/10/2010,8/20/2010,10,-2,8
8/10/2010,8/11/2010,9/10/2010,30,1,31
8/11/2010,8/11/2010,8/20/2010,9,0,9
8/12/2010,8/11/2010,9/14/2010,34,-1,33
8/12/2010,8/12/2010,9/13/2010,32,0,32
8/12/2010,8/12/2010,9/13/2010,32,0,32
8/12/2010,8/12/2010,9/13/2010,32,0,32
8/13/2010,8/12/2010,9/15/2010,34,-1,33
8/12/2010,8/12/2010,9/16/2010,35,0,35
8/12/2010,8/12/2010,8/20/2010,8,0,8
8/12/2010,8/12/2010,9/14/2010,33,0,33
8/12/2010,8/12/2010,9/14/2010,33,0,33
8/17/2010,8/13/2010,9/17/2010,35,-4,31
8/13/2010,8/13/2010,9/17/2010,35,0,35
8/13/2010,8/13/2010,9/14/2010,32,0,32
8/13/2010,8/13/2010,10/14/2010,62,0,62
8/17/2010,8/13/2010,9/17/2010,35,-4,31
8/16/2010,8/16/2010,9/15/2010,30,0,30
8/16/2010,8/16/2010,9/15/2010,30,0,30
8/17/2010,8/17/2010,9/17/2010,31,0,31
8/17/2010,8/17/2010,9/17/2010,31,0,31
8/17/2010,8/17/2010,9/17/2010,31,0,31
8/17/2010,8/17/2010,9/17/2010,31,0,31
8/17/2010,8/17/2010,9/17/2010,31,0,31
8/17/2010,8/17/2010,10/18/2010,62,0,62
8/17/2010,8/17/2010,9/15/2010,29,0,29
8/19/2010,8/18/2010,9/17/2010,30,-1,29
8/18/2010,8/18/2010,10/22/2010,65,0,65
8/19/2010,8/18/2010,8/27/2010,9,-1,8
8/18/2010,8/18/2010,8/27/2010,9,0,9
8/19/2010,8/19/2010,9/20/2010,32,0,32
8/19/2010,8/19/2010,9/20/2010,32,0,32
8/19/2010,8/19/2010,8/27/2010,8,0,8
8/19/2010,8/19/2010,8/24/2010,5,0,5
8/19/2010,8/19/2010,9/20/2010,32,0,32
8/19/2010,8/19/2010,9/1/2010,13,0,13
8/20/2010,8/20/2010,9/23/2010,34,0,34
8/20/2010,8/20/2010,9/23/2010,34,0,34
8/20/2010,8/20/2010,11/22/2010,94,0,94
8/26/2010,8/26/2010,9/28/2010,33,0,33
8/26/2010,8/26/2010,9/28/2010,33,0,33
8/26/2010,8/26/2010,9/28/2010,33,0,33
8/26/2010,8/26/2010,9/3/2010,8,0,8
8/27/2010,8/26/2010,9/7/2010,12,-1,11
8/27/2010,8/27/2010,9/30/2010,34,0,34
8/31/2010,8/31/2010,9/13/2010,13,0,13
9/1/2010,9/1/2010,9/13/2010,12,0,12
9/1/2010,9/1/2010,9/13/2010,12,0,12
9/2/2010,9/2/2010,9/10/2010,8,0,8
9/2/2010,9/2/2010,9/10/2010,8,0,8
9/2/2010,9/2/2010,10/6/2010,34,0,34
9/2/2010,9/2/2010,9/14/2010,12,0,12
9/2/2010,9/2/2010,10/12/2010,40,0,40
9/3/2010,9/3/2010,10/5/2010,32,0,32
9/3/2010,9/3/2010,10/5/2010,32,0,32
9/3/2010,9/3/2010,10/5/2010,32,0,32
9/3/2010,9/3/2010,10/5/2010,32,0,32
9/3/2010,9/3/2010,10/5/2010,32,0,32
9/3/2010,9/3/2010,10/7/2010,34,0,34
9/3/2010,9/3/2010,10/7/2010,34,0,34
9/7/2010,9/3/2010,9/14/2010,11,-4,7
9/7/2010,9/3/2010,9/14/2010,11,-4,7
9/7/2010,9/3/2010,10/6/2010,33,-4,29
9/7/2010,9/7/2010,10/8/2010,31,0,31
9/7/2010,9/7/2010,10/8/2010,31,0,31
9/8/2010,9/8/2010,10/6/2010,28,0,28
9/8/2010,9/8/2010,11/9/2010,62,0,62
9/8/2010,9/8/2010,10/8/2010,30,0,30
9/10/2010,9/8/2010,10/12/2010,34,-2,32
9/10/2010,9/10/2010,9/17/2010,7,0,7
9/10/2010,9/10/2010,9/17/2010,7,0,7
9/10/2010,9/10/2010,9/17/2010,7,0,7
9/10/2010,9/10/2010,9/17/2010,7,0,7
9/13/2010,9/10/2010,12/14/2010,95,-3,92
9/13/2010,9/10/2010,10/15/2010,35,-3,32
9/10/2010,9/10/2010,10/14/2010,34,0,34
9/13/2010,9/10/2010,10/14/2010,34,-3,31
9/10/2010,9/10/2010,10/14/2010,34,0,34
9/13/2010,9/10/2010,10/4/2010,24,-3,21
9/10/2010,9/10/2010,9/20/2010,10,0,10
9/13/2010,9/13/2010,10/12/2010,29,0,29
9/13/2010,9/13/2010,10/12/2010,29,0,29
9/13/2010,9/13/2010,10/12/2010,29,0,29
9/13/2010,9/13/2010,10/12/2010,29,0,29
9/13/2010,9/13/2010,10/12/2010,29,0,29
9/13/2010,9/13/2010,10/14/2010,31,0,31
9/13/2010,9/13/2010,10/14/2010,31,0,31
9/13/2010,9/13/2010,9/21/2010,8,0,8
9/13/2010,9/13/2010,9/21/2010,8,0,8
9/14/2010,9/14/2010,10/15/2010,31,0,31
9/14/2010,9/14/2010,12/20/2010,97,0,97
9/14/2010,9/14/2010,10/14/2010,30,0,30
9/15/2010,9/15/2010,10/15/2010,30,0,30
9/15/2010,9/15/2010,10/15/2010,30,0,30
9/15/2010,9/15/2010,10/15/2010,30,0,30
9/15/2010,9/15/2010,10/15/2010,30,0,30
9/15/2010,9/15/2010,10/19/2010,34,0,34
9/15/2010,9/15/2010,10/18/2010,33,0,33
9/16/2010,9/15/2010,10/18/2010,33,-1,32
9/16/2010,9/16/2010,9/28/2010,12,0,12
9/16/2010,9/16/2010,9/28/2010,12,0,12
9/17/2010,9/16/2010,10/20/2010,34,-1,33
9/16/2010,9/16/2010,9/22/2010,6,0,6
9/16/2010,9/16/2010,10/19/2010,33,0,33
9/16/2010,9/16/2010,10/19/2010,33,0,33
9/17/2010,9/17/2010,10/18/2010,31,0,31
9/17/2010,9/17/2010,10/18/2010,31,0,31
9/17/2010,9/17/2010,10/18/2010,31,0,31
9/17/2010,9/17/2010,10/18/2010,31,0,31
9/17/2010,9/17/2010,10/18/2010,31,0,31
9/17/2010,9/17/2010,12/14/2010,88,0,88
9/17/2010,9/17/2010,10/19/2010,32,0,32
9/20/2010,9/20/2010,10/19/2010,29,0,29
9/20/2010,9/20/2010,10/19/2010,29,0,29
9/20/2010,9/20/2010,9/28/2010,8,0,8
9/20/2010,9/20/2010,10/14/2010,24,0,24
9/22/2010,9/21/2010,10/25/2010,34,-1,33
9/21/2010,9/21/2010,10/25/2010,34,0,34
9/21/2010,9/21/2010,9/24/2010,3,0,3
9/22/2010,9/22/2010,12/20/2010,89,0,89
9/22/2010,9/22/2010,10/25/2010,33,0,33
9/22/2010,9/22/2010,10/25/2010,33,0,33
9/23/2010,9/23/2010,9/28/2010,5,0,5
9/23/2010,9/23/2010,10/1/2010,8,0,8
9/23/2010,9/23/2010,10/1/2010,8,0,8
9/27/2010,9/24/2010,10/4/2010,10,-3,7
9/27/2010,9/27/2010,10/29/2010,32,0,32
9/27/2010,9/27/2010,10/27/2010,30,0,30
9/27/2010,9/27/2010,10/29/2010,32,0,32
9/29/2010,9/29/2010,11/9/2010,41,0,41
10/4/2010,9/30/2010,10/13/2010,13,-4,9
10/1/2010,9/30/2010,10/8/2010,8,-1,7
10/1/2010,9/30/2010,10/8/2010,8,-1,7
10/1/2010,9/30/2010,10/8/2010,8,-1,7
10/4/2010,10/4/2010,10/19/2010,15,0,15
10/4/2010,10/4/2010,10/13/2010,9,0,9
10/5/2010,10/5/2010,11/3/2010,29,0,29
10/5/2010,10/5/2010,11/3/2010,29,0,29
10/5/2010,10/5/2010,11/3/2010,29,0,29
10/5/2010,10/5/2010,11/3/2010,29,0,29
10/6/2010,10/5/2010,10/15/2010,10,-1,9
10/5/2010,10/5/2010,1/10/2011,97,0,97
10/5/2010,10/5/2010,1/6/2011,93,0,93
10/6/2010,10/6/2010,11/8/2010,33,0,33
10/7/2010,10/7/2010,10/15/2010,8,0,8
10/7/2010,10/7/2010,11/10/2010,34,0,34
10/7/2010,10/7/2010,11/10/2010,34,0,34
10/7/2010,10/7/2010,11/10/2010,34,0,34
10/7/2010,10/7/2010,10/15/2010,8,0,8
10/7/2010,10/7/2010,10/15/2010,8,0,8
10/7/2010,10/7/2010,11/9/2010,33,0,33
10/7/2010,10/7/2010,10/11/2010,4,0,4
10/8/2010,10/8/2010,11/8/2010,31,0,31
10/8/2010,10/8/2010,11/8/2010,31,0,31
10/8/2010,10/8/2010,11/8/2010,31,0,31
10/8/2010,10/8/2010,1/12/2011,96,0,96
10/8/2010,10/8/2010,11/9/2010,32,0,32
10/8/2010,10/8/2010,11/10/2010,33,0,33
10/8/2010,10/8/2010,1/10/2011,94,0,94
10/12/2010,10/12/2010,11/12/2010,31,0,31
10/12/2010,10/12/2010,11/12/2010,31,0,31
10/12/2010,10/12/2010,11/12/2010,31,0,31
10/12/2010,10/12/2010,11/12/2010,31,0,31
10/12/2010,10/12/2010,11/12/2010,31,0,31
10/12/2010,10/12/2010,11/12/2010,31,0,31
10/12/2010,10/12/2010,11/16/2010,35,0,35
10/12/2010,10/12/2010,1/13/2011,93,0,93
10/13/2010,10/13/2010,11/15/2010,33,0,33
10/13/2010,10/13/2010,1/14/2011,93,0,93
10/13/2010,10/13/2010,11/16/2010,34,0,34
10/13/2010,10/13/2010,1/12/2011,91,0,91
10/13/2010,10/13/2010,11/18/2010,36,0,36
10/14/2010,10/14/2010,11/17/2010,34,0,34
10/14/2010,10/14/2010,10/22/2010,8,0,8
10/14/2010,10/14/2010,11/17/2010,34,0,34
10/15/2010,10/15/2010,11/15/2010,31,0,31
10/14/2010,10/14/2010,10/22/2010,8,0,8
10/14/2010,10/14/2010,10/22/2010,8,0,8
10/15/2010,10/15/2010,11/18/2010,34,0,34
10/15/2010,10/15/2010,1/18/2011,95,0,95
10/14/2010,10/14/2010,10/29/2010,15,0,15
10/15/2010,10/15/2010,11/15/2010,31,0,31
10/18/2010,10/18/2010,11/17/2010,30,0,30
10/18/2010,10/18/2010,11/17/2010,30,0,30
10/18/2010,10/18/2010,11/17/2010,30,0,30
10/18/2010,10/18/2010,11/17/2010,30,0,30
10/18/2010,10/18/2010,11/18/2010,31,0,31
10/18/2010,10/18/2010,11/18/2010,31,0,31
10/18/2010,10/18/2010,11/18/2010,31,0,31
10/18/2010,10/18/2010,11/22/2010,35,0,35
10/18/2010,10/18/2010,11/4/2010,17,0,17
10/19/2010,10/19/2010,11/19/2010,31,0,31
10/19/2010,10/19/2010,11/19/2010,31,0,31
10/19/2010,10/19/2010,11/19/2010,31,0,31
10/20/2010,10/20/2010,10/27/2010,7,0,7
10/20/2010,10/20/2010,11/22/2010,33,0,33
10/22/2010,10/21/2010,11/22/2010,32,-1,31
10/21/2010,10/21/2010,10/29/2010,8,0,8
10/21/2010,10/21/2010,10/29/2010,8,0,8
10/21/2010,10/21/2010,10/29/2010,8,0,8
10/21/2010,10/21/2010,11/5/2010,15,0,15
10/22/2010,10/22/2010,11/22/2010,31,0,31
10/22/2010,10/22/2010,1/21/2011,91,0,91
10/22/2010,10/22/2010,11/22/2010,31,0,31
10/27/2010,10/27/2010,11/4/2010,8,0,8
10/27/2010,10/27/2010,11/4/2010,8,0,8
10/27/2010,10/27/2010,11/4/2010,8,0,8
10/27/2010,10/27/2010,11/30/2010,34,0,34
10/28/2010,10/28/2010,11/30/2010,33,0,33
11/5/2010,11/5/2010,11/12/2010,7,0,7
11/3/2010,11/3/2010,12/3/2010,30,0,30
11/3/2010,11/3/2010,12/3/2010,30,0,30
11/3/2010,11/3/2010,12/3/2010,30,0,30
11/3/2010,11/3/2010,12/3/2010,30,0,30
11/3/2010,11/3/2010,12/3/2010,30,0,30
11/4/2010,11/4/2010,11/22/2010,18,0,18
11/4/2010,11/4/2010,12/3/2010,29,0,29
11/4/2010,11/4/2010,11/15/2010,11,0,11
11/4/2010,11/4/2010,11/5/2010,1,0,1
11/4/2010,11/4/2010,11/5/2010,1,0,1
11/4/2010,11/4/2010,11/5/2010,1,0,1
11/4/2010,11/4/2010,11/5/2010,1,0,1
11/4/2010,11/4/2010,11/29/2010,25,0,25
11/4/2010,11/4/2010,11/29/2010,25,0,25
11/5/2010,11/5/2010,12/7/2010,32,0,32
11/5/2010,11/5/2010,11/12/2010,7,0,7
11/5/2010,11/5/2010,12/3/2010,28,0,28
11/5/2010,11/5/2010,12/7/2010,32,0,32
11/5/2010,11/5/2010,12/7/2010,32,0,32
11/5/2010,11/5/2010,11/15/2010,10,0,10
11/8/2010,11/8/2010,12/7/2010,29,0,29
11/10/2010,11/8/2010,12/9/2010,31,-2,29
11/9/2010,11/9/2010,12/9/2010,30,0,30
11/9/2010,11/9/2010,12/9/2010,30,0,30
11/9/2010,11/9/2010,1/12/2011,64,0,64
11/9/2010,11/9/2010,2/8/2011,91,0,91
11/10/2010,11/9/2010,12/14/2010,35,-1,34
11/10/2010,11/10/2010,12/10/2010,30,0,30
11/10/2010,11/10/2010,1/11/2011,62,0,62
11/10/2010,11/10/2010,11/19/2010,9,0,9
11/12/2010,11/10/2010,12/15/2010,35,-2,33
11/12/2010,11/12/2010,12/13/2010,31,0,31
11/12/2010,11/12/2010,12/13/2010,31,0,31
11/12/2010,11/12/2010,12/13/2010,31,0,31
11/12/2010,11/12/2010,12/13/2010,31,0,31
11/12/2010,11/12/2010,12/14/2010,32,0,32
11/12/2010,11/12/2010,2/9/2011,89,0,89
11/15/2010,11/15/2010,12/15/2010,30,0,30
11/15/2010,11/15/2010,12/15/2010,30,0,30
11/12/2010,11/12/2010,11/19/2010,7,0,7
11/12/2010,11/12/2010,11/30/2010,18,0,18
11/12/2010,11/12/2010,2/14/2011,94,0,94
11/12/2010,11/12/2010,11/22/2010,10,0,10
11/15/2010,11/15/2010,12/15/2010,30,0,30
11/15/2010,11/15/2010,12/15/2010,30,0,30
11/15/2010,11/15/2010,12/14/2010,29,0,29
11/15/2010,11/15/2010,12/17/2010,32,0,32
11/15/2010,11/15/2010,12/15/2010,30,0,30
11/17/2010,11/17/2010,12/17/2010,30,0,30
11/17/2010,11/17/2010,12/15/2010,28,0,28
11/17/2010,11/17/2010,11/24/2010,7,0,7
11/17/2010,11/17/2010,2/17/2011,92,0,92
11/17/2010,11/17/2010,12/16/2010,29,0,29
11/17/2010,11/17/2010,12/16/2010,29,0,29
11/17/2010,11/17/2010,12/20/2010,33,0,33
11/17/2010,11/17/2010,12/20/2010,33,0,33
11/17/2010,11/17/2010,1/18/2011,62,0,62
11/17/2010,11/17/2010,12/17/2010,30,0,30
11/19/2010,11/18/2010,12/20/2010,32,-1,31
11/18/2010,11/18/2010,11/29/2010,11,0,11
11/18/2010,11/18/2010,12/3/2010,15,0,15
11/19/2010,11/19/2010,12/20/2010,31,0,31
11/19/2010,11/19/2010,12/20/2010,31,0,31
11/19/2010,11/19/2010,12/20/2010,31,0,31
11/19/2010,11/19/2010,11/30/2010,11,0,11
11/19/2010,11/19/2010,12/20/2010,31,0,31
11/19/2010,11/19/2010,2/18/2011,91,0,91
11/19/2010,11/19/2010,11/30/2010,11,0,11
11/23/2010,11/23/2010,11/26/2010,3,0,3
11/24/2010,11/24/2010,12/3/2010,9,0,9
11/24/2010,11/24/2010,12/3/2010,9,0,9
11/26/2010,11/26/2010,1/7/2011,42,0,42
11/30/2010,11/26/2010,12/30/2010,34,-4,30
11/30/2010,11/29/2010,12/30/2010,31,-1,30
12/2/2010,12/1/2010,12/14/2010,13,-1,12
11/30/2010,11/29/2010,12/15/2010,16,-1,15
11/29/2010,11/29/2010,12/7/2010,8,0,8
11/30/2010,11/29/2010,1/28/2011,60,-1,59
12/2/2010,12/2/2010,12/10/2010,8,0,8
12/2/2010,12/2/2010,12/10/2010,8,0,8
12/2/2010,12/2/2010,1/7/2011,36,0,36
12/3/2010,12/3/2010,1/4/2011,32,0,32
12/3/2010,12/3/2010,1/4/2011,32,0,32
12/3/2010,12/3/2010,1/4/2011,32,0,32
12/3/2010,12/3/2010,1/4/2011,32,0,32
12/3/2010,12/3/2010,1/4/2011,32,0,32
12/3/2010,12/3/2010,1/10/2011,38,0,38
12/6/2010,12/3/2010,1/6/2011,34,-3,31
12/6/2010,12/6/2010,1/10/2011,35,0,35
12/6/2010,12/6/2010,1/10/2011,35,0,35
12/6/2010,12/6/2010,1/6/2011,31,0,31
12/6/2010,12/6/2010,12/15/2010,9,0,9
12/7/2010,12/7/2010,1/10/2011,34,0,34
12/7/2010,12/7/2010,1/10/2011,34,0,34
12/7/2010,12/7/2010,1/10/2011,34,0,34
12/8/2010,12/8/2010,12/31/2010,23,0,23
12/8/2010,12/8/2010,3/8/2011,90,0,90
12/8/2010,12/8/2010,1/12/2011,35,0,35
12/10/2010,12/9/2010,12/17/2010,8,-1,7
12/10/2010,12/9/2010,12/17/2010,8,-1,7
12/9/2010,12/9/2010,1/10/2011,32,0,32
12/10/2010,12/10/2010,1/11/2011,32,0,32
12/10/2010,12/10/2010,1/14/2011,35,0,35
12/10/2010,12/10/2010,1/14/2011,35,0,35
12/13/2010,12/10/2010,1/14/2011,35,-3,32
12/13/2010,12/10/2010,12/21/2010,11,-3,8
12/10/2010,12/10/2010,1/17/2011,38,0,38
12/10/2010,12/10/2010,1/17/2011,38,0,38
12/13/2010,12/13/2010,1/12/2011,30,0,30
12/13/2010,12/13/2010,1/12/2011,30,0,30
12/13/2010,12/13/2010,1/12/2011,30,0,30
12/13/2010,12/13/2010,1/12/2011,30,0,30
12/13/2010,12/13/2010,1/14/2011,32,0,32
12/13/2010,12/13/2010,12/21/2010,8,0,8
12/13/2010,12/13/2010,3/18/2011,95,0,95
12/14/2010,12/14/2010,1/20/2011,37,0,37
12/14/2010,12/14/2010,1/14/2011,31,0,31
12/14/2010,12/14/2010,1/14/2011,31,0,31
12/14/2010,12/14/2010,1/14/2011,31,0,31
12/14/2010,12/14/2010,12/22/2010,8,0,8
12/14/2010,12/14/2010,1/17/2011,34,0,34
12/15/2010,12/15/2010,1/17/2011,33,0,33
12/15/2010,12/15/2010,1/17/2011,33,0,33
12/15/2010,12/15/2010,1/17/2011,33,0,33
12/15/2010,12/15/2010,1/17/2011,33,0,33
12/15/2010,12/15/2010,1/17/2011,33,0,33
12/15/2010,12/15/2010,1/20/2011,36,0,36
12/17/2010,12/16/2010,1/20/2011,35,-1,34
12/16/2010,12/16/2010,1/18/2011,33,0,33
12/16/2010,12/16/2010,12/29/2010,13,0,13
12/16/2010,12/16/2010,12/29/2010,13,0,13
12/17/2010,12/17/2010,1/14/2011,28,0,28
12/17/2010,12/17/2010,1/14/2011,28,0,28
12/17/2010,12/17/2010,1/14/2011,28,0,28
12/17/2010,12/17/2010,1/14/2011,28,0,28
12/17/2010,12/17/2010,12/28/2010,11,0,11
12/17/2010,12/17/2010,1/20/2011,34,0,34
12/17/2010,12/17/2010,1/20/2011,34,0,34
12/17/2010,12/17/2010,12/21/2010,4,0,4
12/20/2010,12/20/2010,1/19/2011,30,0,30
12/20/2010,12/20/2010,1/19/2011,30,0,30
12/20/2010,12/20/2010,1/18/2011,29,0,29
12/20/2010,12/20/2010,12/28/2010,8,0,8
12/21/2010,12/21/2010,12/30/2010,9,0,9
12/21/2010,12/21/2010,12/30/2010,9,0,9
12/22/2010,12/22/2010,1/18/2011,27,0,27
12/27/2010,12/27/2010,1/7/2011,11,0,11
12/28/2010,12/28/2010,1/28/2011,31,0,31
12/29/2010,12/29/2010,1/31/2011,33,0,33
12/29/2010,12/29/2010,1/10/2011,12,0,12
12/30/2010,12/30/2010,1/5/2011,6,0,6
1/4/2011,1/4/2011,2/7/2011,34,0,34
1/4/2011,1/4/2011,2/7/2011,34,0,34
1/4/2011,1/4/2011,2/7/2011,34,0,34
1/4/2011,1/4/2011,2/7/2011,34,0,34
1/4/2011,1/4/2011,2/7/2011,34,0,34
1/4/2011,1/4/2011,2/7/2011,34,0,34
1/5/2011,1/4/2011,2/4/2011,31,-1,30
1/4/2011,1/4/2011,1/14/2011,10,0,10
1/4/2011,1/4/2011,2/4/2011,31,0,31
1/4/2011,1/4/2011,1/21/2011,17,0,17
1/5/2011,1/5/2011,2/4/2011,30,0,30
1/5/2011,1/5/2011,3/17/2011,71,0,71
1/6/2011,1/6/2011,1/14/2011,8,0,8
1/6/2011,1/6/2011,1/21/2011,15,0,15
1/10/2011,1/7/2011,2/9/2011,33,-3,30
1/10/2011,1/10/2011,2/9/2011,30,0,30
1/10/2011,1/10/2011,2/9/2011,30,0,30
1/7/2011,1/7/2011,2/10/2011,34,0,34
1/7/2011,1/7/2011,1/14/2011,7,0,7
1/7/2011,1/7/2011,4/11/2011,94,0,94
1/7/2011,1/7/2011,2/11/2011,35,0,35
1/7/2011,1/7/2011,2/11/2011,35,0,35
1/7/2011,1/7/2011,4/8/2011,91,0,91
1/7/2011,1/7/2011,4/8/2011,91,0,91
1/10/2011,1/10/2011,2/9/2011,30,0,30
1/10/2011,1/10/2011,2/9/2011,30,0,30
1/10/2011,1/10/2011,2/9/2011,30,0,30
1/11/2011,1/11/2011,4/11/2011,90,0,90
1/11/2011,1/11/2011,2/8/2011,28,0,28
1/12/2011,1/12/2011,2/14/2011,33,0,33
1/12/2011,1/12/2011,2/14/2011,33,0,33
1/12/2011,1/12/2011,4/13/2011,91,0,91
1/12/2011,1/12/2011,2/14/2011,33,0,33
1/13/2011,1/12/2011,2/14/2011,33,-1,32
1/12/2011,1/12/2011,4/13/2011,91,0,91
1/13/2011,1/13/2011,2/14/2011,32,0,32
1/13/2011,1/13/2011,3/18/2011,64,0,64
1/13/2011,1/13/2011,2/11/2011,29,0,29
1/14/2011,1/13/2011,2/17/2011,35,-1,34
1/14/2011,1/13/2011,2/17/2011,35,-1,34
1/14/2011,1/13/2011,2/17/2011,35,-1,34
1/13/2011,1/13/2011,2/15/2011,33,0,33
1/14/2011,1/13/2011,2/14/2011,32,-1,31
1/13/2011,1/13/2011,2/11/2011,29,0,29
1/13/2011,1/13/2011,4/15/2011,92,0,92
1/13/2011,1/13/2011,1/21/2011,8,0,8
1/13/2011,1/13/2011,1/24/2011,11,0,11
1/13/2011,1/13/2011,2/15/2011,33,0,33
1/14/2011,1/14/2011,2/17/2011,34,0,34
1/14/2011,1/14/2011,2/17/2011,34,0,34
1/14/2011,1/14/2011,2/17/2011,34,0,34
1/17/2011,1/17/2011,2/15/2011,29,0,29
1/17/2011,1/17/2011,2/15/2011,29,0,29
1/17/2011,1/17/2011,2/14/2011,28,0,28
1/17/2011,1/17/2011,1/24/2011,7,0,7
1/17/2011,1/17/2011,1/21/2011,4,0,4
1/18/2011,1/17/2011,1/19/2011,2,-1,1
1/19/2011,1/18/2011,2/16/2011,29,-1,28
1/19/2011,1/18/2011,2/18/2011,31,-1,30
1/18/2011,1/18/2011,2/18/2011,31,0,31
1/19/2011,1/19/2011,2/21/2011,33,0,33
1/19/2011,1/19/2011,2/21/2011,33,0,33
1/19/2011,1/19/2011,2/21/2011,33,0,33
1/19/2011,1/19/2011,2/16/2011,28,0,28
1/19/2011,1/19/2011,2/16/2011,28,0,28
1/20/2011,1/20/2011,1/28/2011,8,0,8
1/20/2011,1/20/2011,1/28/2011,8,0,8
1/20/2011,1/20/2011,2/16/2011,27,0,27
1/20/2011,1/20/2011,4/18/2011,88,0,88
1/27/2011,1/27/2011,2/25/2011,29,0,29
1/24/2011,1/24/2011,1/28/2011,4,0,4
1/26/2011,1/26/2011,2/18/2011,23,0,23
1/27/2011,1/27/2011,2/25/2011,29,0,29
1/27/2011,1/27/2011,2/25/2011,29,0,29
1/27/2011,1/27/2011,2/18/2011,22,0,22
1/27/2011,1/27/2011,2/18/2011,22,0,22
1/28/2011,1/28/2011,2/28/2011,31,0,31
2/3/2011,2/3/2011,3/9/2011,34,0,34
2/3/2011,2/3/2011,5/4/2011,90,0,90
2/3/2011,2/3/2011,2/25/2011,22,0,22
2/3/2011,2/3/2011,3/4/2011,29,0,29
2/3/2011,2/3/2011,2/11/2011,8,0,8
2/3/2011,2/3/2011,2/17/2011,14,0,14
2/4/2011,2/4/2011,3/7/2011,31,0,31
2/7/2011,2/7/2011,3/3/2011,24,0,24
2/7/2011,2/7/2011,3/3/2011,24,0,24
2/7/2011,2/7/2011,3/3/2011,24,0,24
2/7/2011,2/7/2011,3/3/2011,24,0,24
2/7/2011,2/7/2011,3/8/2011,29,0,29
2/7/2011,2/7/2011,3/31/2011,52,0,52
2/8/2011,2/8/2011,2/16/2011,8,0,8
2/8/2011,2/8/2011,3/9/2011,29,0,29
2/8/2011,2/8/2011,4/11/2011,62,0,62
2/8/2011,2/8/2011,5/10/2011,91,0,91
2/8/2011,2/8/2011,2/17/2011,9,0,9
2/9/2011,2/9/2011,3/7/2011,26,0,26
2/9/2011,2/9/2011,3/7/2011,26,0,26
2/10/2011,2/10/2011,3/10/2011,28,0,28
2/10/2011,2/10/2011,3/10/2011,28,0,28
2/11/2011,2/10/2011,3/14/2011,32,-1,31
2/10/2011,2/10/2011,2/18/2011,8,0,8
2/10/2011,2/10/2011,2/18/2011,8,0,8
2/10/2011,2/10/2011,2/18/2011,8,0,8
2/10/2011,2/10/2011,5/13/2011,92,0,92
2/14/2011,2/14/2011,3/14/2011,28,0,28
2/14/2011,2/14/2011,3/15/2011,29,0,29
2/15/2011,2/15/2011,3/15/2011,28,0,28
2/15/2011,2/15/2011,3/15/2011,28,0,28
2/15/2011,2/15/2011,3/15/2011,28,0,28
2/15/2011,2/15/2011,3/17/2011,30,0,30
2/15/2011,2/15/2011,3/17/2011,30,0,30
2/15/2011,2/15/2011,3/17/2011,30,0,30
2/15/2011,2/15/2011,3/16/2011,29,0,29
2/15/2011,2/15/2011,3/9/2011,22,0,22
2/17/2011,2/17/2011,3/17/2011,28,0,28
2/17/2011,2/17/2011,3/17/2011,28,0,28
2/17/2011,2/17/2011,3/17/2011,28,0,28
2/17/2011,2/17/2011,3/14/2011,25,0,25
2/17/2011,2/17/2011,3/17/2011,28,0,28
2/17/2011,2/17/2011,3/17/2011,28,0,28
2/17/2011,2/17/2011,3/17/2011,28,0,28
2/17/2011,2/17/2011,2/24/2011,7,0,7
2/17/2011,2/17/2011,4/18/2011,60,0,60
2/17/2011,2/17/2011,3/16/2011,27,0,27
2/17/2011,2/17/2011,3/8/2011,19,0,19
2/17/2011,2/17/2011,5/20/2011,92,0,92
2/17/2011,2/17/2011,2/24/2011,7,0,7
2/17/2011,2/17/2011,2/25/2011,8,0,8
2/17/2011,2/17/2011,2/25/2011,8,0,8
2/17/2011,2/17/2011,5/18/2011,90,0,90
2/17/2011,2/17/2011,3/21/2011,32,0,32
2/18/2011,2/18/2011,3/21/2011,31,0,31
2/21/2011,2/21/2011,3/21/2011,28,0,28
2/23/2011,2/23/2011,3/4/2011,9,0,9
2/23/2011,2/23/2011,3/4/2011,9,0,9
2/24/2011,2/24/2011,3/31/2011,35,0,35
2/24/2011,2/24/2011,5/27/2011,92,0,92
2/24/2011,2/24/2011,3/30/2011,34,0,34
2/24/2011,2/24/2011,3/4/2011,8,0,8
2/24/2011,2/24/2011,3/25/2011,29,0,29
3/3/2011,3/3/2011,4/4/2011,32,0,32
3/3/2011,3/3/2011,4/4/2011,32,0,32
3/3/2011,3/3/2011,4/4/2011,32,0,32
3/3/2011,3/3/2011,4/4/2011,32,0,32
3/3/2011,3/3/2011,4/4/2011,32,0,32
3/3/2011,3/3/2011,3/11/2011,8,0,8
3/3/2011,3/3/2011,3/11/2011,8,0,8
3/3/2011,3/3/2011,3/11/2011,8,0,8
3/3/2011,3/3/2011,6/7/2011,96,0,96
3/3/2011,3/3/2011,6/7/2011,96,0,96
3/3/2011,3/3/2011,4/8/2011,36,0,36
3/3/2011,3/3/2011,3/14/2011,11,0,11
3/4/2011,3/4/2011,4/7/2011,34,0,34
3/7/2011,3/7/2011,4/8/2011,32,0,32
3/8/2011,3/7/2011,4/11/2011,35,-1,34
3/9/2011,3/7/2011,4/11/2011,35,-2,33
3/9/2011,3/8/2011,4/6/2011,29,-1,28
3/9/2011,3/8/2011,5/9/2011,62,-1,61
3/9/2011,3/8/2011,4/11/2011,34,-1,33
3/8/2011,3/8/2011,4/11/2011,34,0,34
3/10/2011,3/10/2011,4/11/2011,32,0,32
3/10/2011,3/10/2011,4/11/2011,32,0,32
3/10/2011,3/10/2011,3/18/2011,8,0,8
3/10/2011,3/10/2011,3/18/2011,8,0,8
3/10/2011,3/10/2011,3/18/2011,8,0,8
3/10/2011,3/10/2011,5/13/2011,64,0,64
3/11/2011,3/10/2011,4/14/2011,35,-1,34
3/14/2011,3/11/2011,4/15/2011,35,-3,32
3/11/2011,3/11/2011,3/22/2011,11,0,11
3/11/2011,3/11/2011,5/13/2011,63,0,63
3/14/2011,3/14/2011,4/12/2011,29,0,29
3/14/2011,3/14/2011,4/12/2011,29,0,29
3/14/2011,3/14/2011,4/12/2011,29,0,29
3/14/2011,3/14/2011,4/12/2011,29,0,29
3/14/2011,3/14/2011,4/15/2011,32,0,32
3/14/2011,3/14/2011,5/16/2011,63,0,63
3/15/2011,3/15/2011,4/15/2011,31,0,31
3/15/2011,3/15/2011,4/19/2011,35,0,35
3/15/2011,3/15/2011,4/18/2011,34,0,34
3/15/2011,3/15/2011,4/18/2011,34,0,34
3/15/2011,3/15/2011,4/18/2011,34,0,34
3/15/2011,3/15/2011,5/18/2011,64,0,64
3/15/2011,3/15/2011,3/23/2011,8,0,8
3/16/2011,3/16/2011,3/24/2011,8,0,8
3/16/2011,3/16/2011,6/7/2011,83,0,83
3/16/2011,3/16/2011,4/18/2011,33,0,33
3/16/2011,3/16/2011,5/17/2011,62,0,62
3/16/2011,3/16/2011,5/19/2011,64,0,64
3/16/2011,3/16/2011,5/19/2011,64,0,64
3/17/2011,3/17/2011,4/18/2011,32,0,32
3/17/2011,3/17/2011,4/18/2011,32,0,32
3/17/2011,3/17/2011,4/18/2011,32,0,32
3/17/2011,3/17/2011,4/20/2011,34,0,34
3/17/2011,3/17/2011,4/20/2011,34,0,34
3/17/2011,3/17/2011,3/25/2011,8,0,8
3/17/2011,3/17/2011,3/25/2011,8,0,8
3/17/2011,3/17/2011,3/25/2011,8,0,8
3/17/2011,3/17/2011,6/20/2011,95,0,95
3/17/2011,3/17/2011,5/13/2011,57,0,57
3/21/2011,3/21/2011,4/19/2011,29,0,29
3/21/2011,3/21/2011,4/19/2011,29,0,29
3/28/2011,3/22/2011,4/26/2011,35,-6,29
3/28/2011,3/22/2011,3/30/2011,8,-6,2
3/22/2011,3/22/2011,5/16/2011,55,0,55
3/28/2011,3/22/2011,6/24/2011,94,-6,88
3/28/2011,3/22/2011,6/24/2011,94,-6,88
3/24/2011,3/24/2011,4/1/2011,8,0,8
3/24/2011,3/24/2011,4/1/2011,8,0,8
3/24/2011,3/24/2011,4/1/2011,8,0,8
3/29/2011,3/29/2011,4/29/2011,31,0,31
3/29/2011,3/29/2011,4/28/2011,30,0,30
3/29/2011,3/29/2011,5/23/2011,55,0,55
3/30/2011,3/30/2011,4/8/2011,9,0,9
3/31/2011,3/31/2011,4/8/2011,8,0,8
3/31/2011,3/31/2011,4/8/2011,8,0,8
3/31/2011,3/31/2011,4/8/2011,8,0,8
3/31/2011,3/31/2011,4/8/2011,8,0,8
4/4/2011,4/4/2011,5/3/2011,29,0,29
4/4/2011,4/4/2011,5/3/2011,29,0,29
4/4/2011,4/4/2011,5/3/2011,29,0,29
4/4/2011,4/4/2011,5/3/2011,29,0,29
4/6/2011,4/6/2011,5/9/2011,33,0,33
4/7/2011,4/7/2011,5/10/2011,33,0,33
4/11/2011,4/7/2011,5/10/2011,33,-4,29
4/7/2011,4/7/2011,5/10/2011,33,0,33
4/7/2011,4/7/2011,4/15/2011,8,0,8
4/7/2011,4/7/2011,4/15/2011,8,0,8
4/7/2011,4/7/2011,4/15/2011,8,0,8
4/8/2011,4/8/2011,5/9/2011,31,0,31
4/8/2011,4/8/2011,5/9/2011,31,0,31
4/8/2011,4/8/2011,5/9/2011,31,0,31
4/8/2011,4/8/2011,5/9/2011,31,0,31
4/11/2011,4/11/2011,5/11/2011,30,0,30
4/11/2011,4/11/2011,6/30/2011,80,0,80
4/12/2011,4/12/2011,5/12/2011,30,0,30
4/12/2011,4/12/2011,5/12/2011,30,0,30
4/13/2011,4/12/2011,5/13/2011,31,-1,30
4/12/2011,4/12/2011,7/13/2011,92,0,92
4/12/2011,4/12/2011,6/16/2011,65,0,65
4/13/2011,4/13/2011,6/16/2011,64,0,64
4/14/2011,4/14/2011,5/18/2011,34,0,34
4/15/2011,4/14/2011,5/18/2011,34,-1,33
4/14/2011,4/14/2011,5/17/2011,33,0,33
4/14/2011,4/14/2011,5/17/2011,33,0,33
4/14/2011,4/14/2011,4/26/2011,12,0,12
4/14/2011,4/14/2011,4/26/2011,12,0,12
4/14/2011,4/14/2011,4/27/2011,13,0,13
4/14/2011,4/14/2011,4/27/2011,13,0,13
4/14/2011,4/14/2011,5/6/2011,22,0,22
4/15/2011,4/15/2011,5/16/2011,31,0,31
4/15/2011,4/15/2011,5/16/2011,31,0,31
4/15/2011,4/15/2011,5/16/2011,31,0,31
4/15/2011,4/15/2011,6/21/2011,67,0,67
4/15/2011,4/15/2011,5/18/2011,33,0,33
4/19/2011,4/19/2011,6/20/2011,62,0,62
4/21/2011,4/21/2011,5/3/2011,12,0,12
4/21/2011,4/21/2011,5/3/2011,12,0,12
4/21/2011,4/21/2011,5/3/2011,12,0,12
4/21/2011,4/21/2011,6/24/2011,64,0,64
4/18/2011,4/27/2011,5/17/2011,20,9,29
4/18/2011,4/27/2011,5/17/2011,20,9,29
5/26/2011,5/26/2011,6/6/2011,11,0,11
5/26/2011,5/26/2011,6/6/2011,11,0,11
5/26/2011,5/26/2011,6/6/2011,11,0,11
5/26/2011,5/26/2011,6/6/2011,11,0,11
5/26/2011,5/26/2011,6/7/2011,12,0,12
5/26/2011,5/26/2011,6/7/2011,12,0,12
6/3/2011,6/3/2011,6/10/2011,7,0,7
6/3/2011,6/3/2011,6/10/2011,7,0,7
6/3/2011,6/3/2011,6/10/2011,7,0,7
6/3/2011,6/3/2011,6/10/2011,7,0,7
6/14/2011,6/14/2011,7/12/2011,28,0,28
6/14/2011,6/14/2011,7/12/2011,28,0,28
6/14/2011,6/14/2011,7/12/2011,28,0,28
6/14/2011,6/14/2011,7/12/2011,28,0,28
6/14/2011,6/14/2011,7/12/2011,28,0,28
6/17/2011,6/17/2011,7/18/2011,31,0,31
6/28/2011,6/28/2011,7/1/2011,3,0,3
6/28/2011,6/28/2011,6/29/2011,1,0,1
6/29/2011,6/29/2011,7/29/2011,30,0,30
6/29/2011,6/29/2011,6/30/2011,1,0,1
6/28/2011,6/28/2011,6/29/2011,1,0,1
6/28/2011,6/28/2011,6/29/2011,1,0,1
6/29/2011,6/29/2011,6/30/2011,1,0,1
6/29/2011,6/29/2011,7/12/2011,13,0,13
6/30/2011,6/30/2011,7/12/2011,12,0,12
6/30/2011,6/30/2011,7/5/2011,5,0,5
6/30/2011,6/30/2011,7/1/2011,1,0,1
6/30/2011,6/30/2011,7/1/2011,1,0,1
6/30/2011,6/30/2011,7/1/2011,1,0,1
5/2/2011,5/2/2011,5/6/2011,4,0,4
5/2/2011,5/2/2011,5/6/2011,4,0,4
5/3/2011,5/3/2011,5/13/2011,10,0,10
5/6/2011,5/5/2011,6/8/2011,34,-1,33
5/5/2011,5/5/2011,5/13/2011,8,0,8
5/5/2011,5/5/2011,5/13/2011,8,0,8
5/5/2011,5/5/2011,5/13/2011,8,0,8
5/5/2011,5/5/2011,8/5/2011,92,0,92
5/6/2011,5/6/2011,5/20/2011,14,0,14
5/9/2011,5/6/2011,6/7/2011,32,-3,29
5/6/2011,5/6/2011,8/5/2011,91,0,91
5/6/2011,5/6/2011,6/30/2011,55,0,55
5/6/2011,5/6/2011,6/10/2011,35,0,35
5/9/2011,5/6/2011,6/10/2011,35,-3,32
5/11/2011,5/11/2011,6/16/2011,36,0,36
5/11/2011,5/11/2011,6/14/2011,34,0,34
5/12/2011,5/12/2011,5/20/2011,8,0,8
5/12/2011,5/12/2011,5/20/2011,8,0,8
5/12/2011,5/12/2011,5/20/2011,8,0,8
5/12/2011,5/12/2011,7/15/2011,64,0,64
5/12/2011,5/12/2011,5/27/2011,15,0,15
5/12/2011,5/12/2011,6/10/2011,29,0,29
5/12/2011,5/12/2011,6/10/2011,29,0,29
5/16/2011,5/12/2011,6/17/2011,36,-4,32
5/13/2011,5/13/2011,6/17/2011,35,0,35
5/13/2011,5/13/2011,6/17/2011,35,0,35
5/13/2011,5/13/2011,6/17/2011,35,0,35
5/17/2011,5/17/2011,6/21/2011,35,0,35
4/26/2011,4/26/2011,5/6/2011,10,0,10
5/16/2011,5/16/2011,6/15/2011,30,0,30
5/16/2011,5/16/2011,6/15/2011,30,0,30
5/17/2011,5/17/2011,6/17/2011,31,0,31
5/17/2011,5/17/2011,6/17/2011,31,0,31
5/18/2011,5/18/2011,7/20/2011,63,0,63
5/19/2011,5/19/2011,6/20/2011,32,0,32
5/19/2011,5/19/2011,6/20/2011,32,0,32
5/19/2011,5/19/2011,6/20/2011,32,0,32
5/19/2011,5/19/2011,6/20/2011,32,0,32
5/19/2011,5/19/2011,5/27/2011,8,0,8
5/19/2011,5/19/2011,5/27/2011,8,0,8
6/3/2011,6/3/2011,7/4/2011,31,0,31
6/3/2011,6/3/2011,7/4/2011,31,0,31
6/3/2011,6/3/2011,7/4/2011,31,0,31
6/6/2011,6/6/2011,9/7/2011,93,0,93
6/6/2011,6/6/2011,9/6/2011,92,0,92
6/6/2011,6/6/2011,7/7/2011,31,0,31
6/6/2011,6/6/2011,8/5/2011,60,0,60
6/7/2011,6/7/2011,7/7/2011,30,0,30
6/8/2011,6/8/2011,7/8/2011,30,0,30
6/8/2011,6/8/2011,7/8/2011,30,0,30
6/8/2011,6/8/2011,7/8/2011,30,0,30
6/9/2011,6/8/2011,7/15/2011,37,-1,36
6/9/2011,6/8/2011,7/12/2011,34,-1,33
6/9/2011,6/9/2011,6/16/2011,7,0,7
6/9/2011,6/9/2011,8/9/2011,61,0,61
6/9/2011,6/9/2011,6/17/2011,8,0,8
6/9/2011,6/9/2011,6/17/2011,8,0,8
6/9/2011,6/9/2011,6/17/2011,8,0,8
6/9/2011,6/9/2011,6/20/2011,11,0,11
6/9/2011,6/9/2011,6/20/2011,11,0,11
6/10/2011,6/10/2011,7/11/2011,31,0,31
6/10/2011,6/10/2011,7/11/2011,31,0,31
6/10/2011,6/10/2011,7/13/2011,33,0,33
6/14/2011,6/14/2011,6/22/2011,8,0,8
6/14/2011,6/14/2011,6/22/2011,8,0,8
4/26/2011,4/26/2011,5/27/2011,31,0,31
4/27/2011,4/27/2011,5/19/2011,22,0,22
4/27/2011,4/27/2011,5/19/2011,22,0,22
4/27/2011,4/27/2011,5/19/2011,22,0,22
5/3/2011,5/3/2011,6/3/2011,31,0,31
5/3/2011,5/3/2011,6/3/2011,31,0,31
5/3/2011,5/3/2011,6/3/2011,31,0,31
5/12/2011,5/12/2011,6/14/2011,33,0,33
5/12/2011,5/12/2011,6/14/2011,33,0,33
5/12/2011,5/12/2011,6/14/2011,33,0,33
5/27/2011,5/27/2011,6/30/2011,34,0,34
6/14/2011,6/14/2011,6/22/2011,8,0,8
6/15/2011,6/14/2011,7/15/2011,31,-1,30
6/15/2011,6/15/2011,7/15/2011,30,0,30
6/15/2011,6/15/2011,7/15/2011,30,0,30
6/15/2011,6/15/2011,7/18/2011,33,0,33
6/15/2011,6/15/2011,7/18/2011,33,0,33
6/16/2011,6/15/2011,7/18/2011,33,-1,32
6/15/2011,6/15/2011,7/18/2011,33,0,33
6/16/2011,6/16/2011,7/20/2011,34,0,34
6/16/2011,6/16/2011,6/24/2011,8,0,8
6/16/2011,6/16/2011,6/24/2011,8,0,8
6/16/2011,6/16/2011,6/24/2011,8,0,8
6/16/2011,6/16/2011,6/22/2011,6,0,6
6/17/2011,6/17/2011,7/20/2011,33,0,33
6/20/2011,6/20/2011,7/19/2011,29,0,29
6/20/2011,6/20/2011,7/19/2011,29,0,29
6/20/2011,6/20/2011,7/19/2011,29,0,29
6/20/2011,6/20/2011,6/27/2011,7,0,7
6/20/2011,6/20/2011,6/27/2011,7,0,7
6/20/2011,6/20/2011,7/18/2011,28,0,28
6/27/2011,6/27/2011,6/30/2011,3,0,3
5/9/2011,5/9/2011,6/8/2011,30,0,30
5/9/2011,5/9/2011,6/8/2011,30,0,30
5/9/2011,5/9/2011,6/8/2011,30,0,30
5/11/2011,5/11/2011,6/10/2011,30,0,30
5/11/2011,5/11/2011,6/10/2011,30,0,30
5/13/2011,5/13/2011,8/16/2011,95,0,95
5/16/2011,5/13/2011,6/17/2011,35,-3,32
6/20/2011,6/20/2011,6/27/2011,7,0,7
6/20/2011,6/20/2011,7/20/2011,30,0,30
6/20/2011,6/20/2011,6/27/2011,7,0,7
6/20/2011,6/20/2011,6/21/2011,1,0,1
6/21/2011,6/21/2011,7/20/2011,29,0,29
6/21/2011,6/21/2011,7/20/2011,29,0,29
6/21/2011,6/21/2011,6/22/2011,1,0,1
6/22/2011,6/22/2011,6/29/2011,7,0,7
6/22/2011,6/22/2011,6/30/2011,8,0,8
6/24/2011,6/22/2011,6/27/2011,5,-2,3
6/22/2011,6/22/2011,7/27/2011,35,0,35
6/22/2011,6/22/2011,7/25/2011,33,0,33
6/23/2011,6/23/2011,7/5/2011,12,0,12
6/23/2011,6/23/2011,6/24/2011,1,0,1
6/23/2011,6/23/2011,6/24/2011,1,0,1
6/23/2011,6/23/2011,7/5/2011,12,0,12
6/23/2011,6/23/2011,7/1/2011,8,0,8
6/23/2011,6/23/2011,7/5/2011,12,0,12
6/24/2011,6/24/2011,6/27/2011,3,0,3
6/24/2011,6/24/2011,6/27/2011,3,0,3
6/27/2011,6/27/2011,7/1/2011,4,0,4
6/24/2011,6/24/2011,6/30/2011,6,0,6
6/24/2011,6/24/2011,6/27/2011,3,0,3
6/27/2011,6/27/2011,6/28/2011,1,0,1
6/27/2011,6/27/2011,7/1/2011,4,0,4
6/27/2011,6/27/2011,10/14/2011,109,0,109
6/27/2011,6/27/2011,6/28/2011,1,0,1
6/27/2011,6/27/2011,6/28/2011,1,0,1
6/28/2011,6/28/2011,10/14/2011,108,0,108
6/28/2011,6/28/2011,7/5/2011,7,0,7
7/1/2011,7/1/2011,7/8/2011,7,0,7
7/1/2011,7/1/2011,7/6/2011,5,0,5
7/1/2011,7/1/2011,7/4/2011,3,0,3
7/1/2011,7/1/2011,7/5/2011,4,0,4
7/12/2011,7/12/2011,8/12/2011,31,0,31
7/12/2011,7/12/2011,8/12/2011,31,0,31
8/1/2011,8/1/2011,8/2/2011,1,0,1
8/1/2011,8/1/2011,8/2/2011,1,0,1
8/1/2011,8/1/2011,8/2/2011,1,0,1
8/1/2011,8/1/2011,8/10/2011,9,0,9
8/2/2011,8/2/2011,8/9/2011,7,0,7
8/2/2011,8/2/2011,8/17/2011,15,0,15
8/1/2011,8/1/2011,8/17/2011,16,0,16
8/1/2011,8/1/2011,8/17/2011,16,0,16
8/1/2011,8/1/2011,8/2/2011,1,0,1
8/3/2011,8/3/2011,9/5/2011,33,0,33
8/2/2011,8/2/2011,8/3/2011,1,0,1
8/2/2011,8/2/2011,8/3/2011,1,0,1
8/2/2011,8/2/2011,8/12/2011,10,0,10
8/2/2011,8/2/2011,8/3/2011,1,0,1
8/2/2011,8/2/2011,8/3/2011,1,0,1
8/2/2011,8/2/2011,8/3/2011,1,0,1
8/2/2011,8/2/2011,8/12/2011,10,0,10
8/2/2011,8/2/2011,8/3/2011,1,0,1
8/2/2011,8/2/2011,8/3/2011,1,0,1
8/3/2011,8/3/2011,9/5/2011,33,0,33
8/3/2011,8/3/2011,9/5/2011,33,0,33
8/3/2011,8/3/2011,8/10/2011,7,0,7
8/3/2011,8/3/2011,8/4/2011,1,0,1
8/3/2011,8/3/2011,8/4/2011,1,0,1
8/3/2011,8/3/2011,8/4/2011,1,0,1
8/3/2011,8/3/2011,8/4/2011,1,0,1
8/3/2011,8/3/2011,8/4/2011,1,0,1
8/3/2011,8/3/2011,8/4/2011,1,0,1
8/3/2011,8/3/2011,8/10/2011,7,0,7
8/3/2011,8/3/2011,8/10/2011,7,0,7
8/3/2011,8/3/2011,8/10/2011,7,0,7
8/4/2011,8/4/2011,8/10/2011,6,0,6
8/4/2011,8/4/2011,8/5/2011,1,0,1
8/4/2011,8/4/2011,8/5/2011,1,0,1
8/4/2011,8/4/2011,8/5/2011,1,0,1
8/4/2011,8/4/2011,8/25/2011,21,0,21
7/4/2011,7/4/2011,7/5/2011,1,0,1
7/4/2011,7/4/2011,7/5/2011,1,0,1
7/5/2011,7/5/2011,8/1/2011,27,0,27
7/5/2011,7/5/2011,7/12/2011,7,0,7
7/5/2011,7/5/2011,7/19/2011,14,0,14
7/5/2011,7/5/2011,7/6/2011,1,0,1
7/6/2011,7/5/2011,7/19/2011,14,-1,13
7/5/2011,7/5/2011,7/6/2011,1,0,1
7/5/2011,7/5/2011,7/22/2011,17,0,17
7/6/2011,7/6/2011,7/22/2011,16,0,16
7/6/2011,7/6/2011,7/7/2011,1,0,1
7/6/2011,7/6/2011,7/7/2011,1,0,1
7/6/2011,7/6/2011,7/18/2011,12,0,12
7/6/2011,7/6/2011,7/19/2011,13,0,13
7/6/2011,7/6/2011,7/8/2011,2,0,2
7/7/2011,7/7/2011,7/15/2011,8,0,8
7/7/2011,7/7/2011,7/8/2011,1,0,1
7/7/2011,7/7/2011,7/8/2011,1,0,1
7/7/2011,7/7/2011,7/8/2011,1,0,1
7/7/2011,7/7/2011,8/10/2011,34,0,34
7/7/2011,7/7/2011,8/10/2011,34,0,34
7/8/2011,7/8/2011,8/9/2011,32,0,32
7/8/2011,7/8/2011,7/15/2011,7,0,7
7/8/2011,7/8/2011,7/28/2011,20,0,20
7/8/2011,7/8/2011,7/28/2011,20,0,20
7/8/2011,7/8/2011,7/22/2011,14,0,14
7/8/2011,7/8/2011,8/9/2011,32,0,32
7/8/2011,7/8/2011,7/11/2011,3,0,3
7/11/2011,7/11/2011,7/13/2011,2,0,2
7/11/2011,7/11/2011,7/15/2011,4,0,4
7/11/2011,7/11/2011,7/12/2011,1,0,1
7/11/2011,7/11/2011,7/12/2011,1,0,1
7/18/2011,7/15/2011,8/17/2011,33,-3,30
7/12/2011,7/12/2011,7/13/2011,1,0,1
7/18/2011,7/15/2011,8/17/2011,33,-3,30
7/4/2011,7/4/2011,8/3/2011,30,0,30
7/4/2011,7/4/2011,8/3/2011,30,0,30
7/4/2011,7/4/2011,8/3/2011,30,0,30
7/15/2011,7/15/2011,8/17/2011,33,0,33
7/18/2011,7/18/2011,8/17/2011,30,0,30
7/18/2011,7/18/2011,8/17/2011,30,0,30
7/18/2011,7/18/2011,7/22/2011,4,0,4
7/18/2011,7/18/2011,7/22/2011,4,0,4
7/18/2011,7/18/2011,7/27/2011,9,0,9
7/18/2011,7/18/2011,8/17/2011,30,0,30
7/18/2011,7/18/2011,7/19/2011,1,0,1
7/18/2011,7/18/2011,7/19/2011,1,0,1
7/18/2011,7/18/2011,7/25/2011,7,0,7
7/19/2011,7/18/2011,7/25/2011,7,-1,6
7/19/2011,7/18/2011,8/3/2011,16,-1,15
7/18/2011,7/18/2011,8/2/2011,15,0,15
7/19/2011,7/18/2011,8/2/2011,15,-1,14
7/18/2011,7/18/2011,7/26/2011,8,0,8
7/29/2011,7/29/2011,8/9/2011,11,0,11
7/29/2011,7/29/2011,8/8/2011,10,0,10
7/29/2011,7/29/2011,8/2/2011,4,0,4
7/29/2011,7/29/2011,8/1/2011,3,0,3
7/29/2011,7/29/2011,8/1/2011,3,0,3
7/29/2011,7/29/2011,8/1/2011,3,0,3
7/29/2011,7/29/2011,8/1/2011,3,0,3
7/29/2011,7/29/2011,8/1/2011,3,0,3
7/29/2011,7/29/2011,8/1/2011,3,0,3
7/29/2011,7/29/2011,8/1/2011,3,0,3
7/29/2011,7/29/2011,8/2/2011,4,0,4
7/29/2011,7/29/2011,8/2/2011,4,0,4
8/4/2011,8/4/2011,8/19/2011,15,0,15
8/8/2011,8/8/2011,8/12/2011,4,0,4
8/8/2011,8/8/2011,8/9/2011,1,0,1
8/8/2011,8/8/2011,8/9/2011,1,0,1
8/8/2011,8/8/2011,8/9/2011,1,0,1
8/8/2011,8/8/2011,8/15/2011,7,0,7
7/11/2011,7/11/2011,8/10/2011,30,0,30
7/11/2011,7/11/2011,8/10/2011,30,0,30
7/15/2011,7/15/2011,8/15/2011,31,0,31
7/15/2011,7/15/2011,8/15/2011,31,0,31
7/15/2011,7/15/2011,8/15/2011,31,0,31
7/18/2011,7/18/2011,7/25/2011,7,0,7
7/18/2011,7/18/2011,7/25/2011,7,0,7
7/19/2011,7/19/2011,8/17/2011,29,0,29
7/19/2011,7/19/2011,8/19/2011,31,0,31
7/19/2011,7/19/2011,7/20/2011,1,0,1
7/19/2011,7/19/2011,7/20/2011,1,0,1
7/19/2011,7/19/2011,7/26/2011,7,0,7
7/20/2011,7/20/2011,7/26/2011,6,0,6
7/20/2011,7/20/2011,7/25/2011,5,0,5
7/20/2011,7/20/2011,8/19/2011,30,0,30
7/20/2011,7/20/2011,7/27/2011,7,0,7
7/22/2011,7/20/2011,7/29/2011,9,-2,7
7/20/2011,7/20/2011,7/21/2011,1,0,1
7/20/2011,7/20/2011,7/21/2011,1,0,1
7/20/2011,7/20/2011,7/21/2011,1,0,1
7/20/2011,7/20/2011,7/21/2011,1,0,1
7/20/2011,7/20/2011,7/28/2011,8,0,8
7/20/2011,7/20/2011,7/27/2011,7,0,7
7/20/2011,7/20/2011,7/21/2011,1,0,1
7/20/2011,7/20/2011,7/27/2011,7,0,7
7/20/2011,7/20/2011,8/9/2011,20,0,20
7/21/2011,7/21/2011,7/27/2011,6,0,6
7/21/2011,7/21/2011,8/9/2011,19,0,19
7/21/2011,7/21/2011,7/22/2011,1,0,1
7/21/2011,7/21/2011,8/23/2011,33,0,33
7/21/2011,7/21/2011,7/22/2011,1,0,1
7/21/2011,7/21/2011,7/22/2011,1,0,1
7/22/2011,7/22/2011,8/1/2011,10,0,10
7/22/2011,7/22/2011,8/2/2011,11,0,11
7/22/2011,7/22/2011,7/25/2011,3,0,3
7/22/2011,7/22/2011,7/25/2011,3,0,3
7/22/2011,7/22/2011,8/1/2011,10,0,10
7/8/2011,7/8/2011,8/8/2011,31,0,31
7/13/2011,7/11/2011,8/12/2011,32,-2,30
7/12/2011,7/12/2011,8/12/2011,31,0,31
7/12/2011,7/12/2011,8/12/2011,31,0,31
7/12/2011,7/12/2011,7/19/2011,7,0,7
7/12/2011,7/12/2011,7/13/2011,1,0,1
7/12/2011,7/12/2011,7/13/2011,1,0,1
7/13/2011,7/13/2011,7/22/2011,9,0,9
7/13/2011,7/13/2011,7/22/2011,9,0,9
7/13/2011,7/13/2011,7/26/2011,13,0,13
7/13/2011,7/13/2011,7/14/2011,1,0,1
7/13/2011,7/13/2011,7/14/2011,1,0,1
7/13/2011,7/13/2011,7/14/2011,1,0,1
7/13/2011,7/13/2011,7/14/2011,1,0,1
7/13/2011,7/13/2011,7/14/2011,1,0,1
7/18/2011,7/13/2011,8/17/2011,35,-5,30
7/18/2011,7/13/2011,8/17/2011,35,-5,30
7/18/2011,7/13/2011,8/17/2011,35,-5,30
7/13/2011,7/13/2011,7/14/2011,1,0,1
7/13/2011,7/13/2011,7/20/2011,7,0,7
7/13/2011,7/13/2011,7/28/2011,15,0,15
7/14/2011,7/14/2011,7/20/2011,6,0,6
7/14/2011,7/14/2011,7/28/2011,14,0,14
7/14/2011,7/14/2011,7/15/2011,1,0,1
7/14/2011,7/14/2011,7/15/2011,1,0,1
7/14/2011,7/14/2011,7/15/2011,1,0,1
7/14/2011,7/14/2011,8/12/2011,29,0,29
7/14/2011,7/14/2011,8/12/2011,29,0,29
7/15/2011,7/14/2011,7/22/2011,8,-1,7
7/15/2011,7/15/2011,7/21/2011,6,0,6
7/15/2011,7/15/2011,7/18/2011,3,0,3
7/15/2011,7/15/2011,7/18/2011,3,0,3
7/15/2011,7/15/2011,7/18/2011,3,0,3
7/22/2011,7/22/2011,7/25/2011,3,0,3
7/22/2011,7/22/2011,7/25/2011,3,0,3
7/22/2011,7/22/2011,7/25/2011,3,0,3
7/19/2011,7/19/2011,8/19/2011,31,0,31
7/19/2011,7/19/2011,8/19/2011,31,0,31
7/22/2011,7/22/2011,7/25/2011,3,0,3
7/22/2011,7/22/2011,7/29/2011,7,0,7
7/22/2011,7/22/2011,7/29/2011,7,0,7
8/4/2011,8/4/2011,8/11/2011,7,0,7
8/4/2011,8/4/2011,8/16/2011,12,0,12
8/5/2011,8/5/2011,8/16/2011,11,0,11
8/5/2011,8/5/2011,8/8/2011,3,0,3
8/5/2011,8/5/2011,8/8/2011,3,0,3
8/5/2011,8/5/2011,8/8/2011,3,0,3
8/5/2011,8/5/2011,8/12/2011,7,0,7
8/5/2011,8/5/2011,8/12/2011,7,0,7
8/8/2011,8/8/2011,9/7/2011,30,0,30
8/8/2011,8/8/2011,9/7/2011,30,0,30
8/8/2011,8/8/2011,9/7/2011,30,0,30
8/8/2011,8/8/2011,9/7/2011,30,0,30
8/9/2011,8/8/2011,9/9/2011,32,-1,31
8/9/2011,8/8/2011,8/16/2011,8,-1,7
8/9/2011,8/9/2011,8/10/2011,1,0,1
8/9/2011,8/9/2011,8/10/2011,1,0,1
8/9/2011,8/9/2011,8/10/2011,1,0,1
8/9/2011,8/9/2011,8/18/2011,9,0,9
8/10/2011,8/9/2011,9/12/2011,34,-1,33
8/10/2011,8/10/2011,9/9/2011,30,0,30
8/10/2011,8/10/2011,9/9/2011,30,0,30
8/10/2011,8/10/2011,9/9/2011,30,0,30
8/10/2011,8/10/2011,8/26/2011,16,0,16
8/10/2011,8/10/2011,8/16/2011,6,0,6
8/10/2011,8/10/2011,8/11/2011,1,0,1
8/10/2011,8/10/2011,8/11/2011,1,0,1
8/10/2011,8/10/2011,8/11/2011,1,0,1
8/10/2011,8/10/2011,8/11/2011,1,0,1
8/10/2011,8/10/2011,8/11/2011,1,0,1
7/25/2011,7/25/2011,8/22/2011,28,0,28
7/25/2011,7/25/2011,7/29/2011,4,0,4
7/25/2011,7/25/2011,7/26/2011,1,0,1
7/25/2011,7/25/2011,7/26/2011,1,0,1
7/25/2011,7/25/2011,7/26/2011,1,0,1
7/25/2011,7/25/2011,7/26/2011,1,0,1
7/25/2011,7/25/2011,7/26/2011,1,0,1
7/25/2011,7/25/2011,8/25/2011,31,0,31
7/25/2011,7/25/2011,8/24/2011,30,0,30
7/26/2011,7/26/2011,8/25/2011,30,0,30
7/26/2011,7/26/2011,8/24/2011,29,0,29
7/26/2011,7/26/2011,8/4/2011,9,0,9
7/26/2011,7/26/2011,7/27/2011,1,0,1
7/26/2011,7/26/2011,7/27/2011,1,0,1
7/26/2011,7/26/2011,7/27/2011,1,0,1
7/26/2011,7/26/2011,7/27/2011,1,0,1
7/26/2011,7/26/2011,8/2/2011,7,0,7
7/27/2011,7/26/2011,8/4/2011,9,-1,8
7/27/2011,7/26/2011,8/2/2011,7,-1,6
7/27/2011,7/26/2011,7/29/2011,3,-1,2
7/27/2011,7/27/2011,8/2/2011,6,0,6
7/27/2011,7/27/2011,7/28/2011,1,0,1
7/27/2011,7/27/2011,7/28/2011,1,0,1
7/27/2011,7/27/2011,7/28/2011,1,0,1
7/28/2011,7/28/2011,7/29/2011,1,0,1
7/28/2011,7/28/2011,7/29/2011,1,0,1
7/28/2011,7/28/2011,7/29/2011,1,0,1
7/28/2011,7/28/2011,7/29/2011,1,0,1
7/28/2011,7/28/2011,7/29/2011,1,0,1
7/28/2011,7/28/2011,7/29/2011,1,0,1
7/28/2011,7/28/2011,8/8/2011,11,0,11
7/28/2011,7/28/2011,8/8/2011,11,0,11
7/28/2011,7/28/2011,8/9/2011,12,0,12
7/28/2011,7/28/2011,8/9/2011,12,0,12
7/28/2011,7/28/2011,8/2/2011,5,0,5
8/1/2011,8/1/2011,8/2/2011,1,0,1
8/1/2011,8/1/2011,8/2/2011,1,0,1
8/1/2011,8/1/2011,8/2/2011,1,0,1
8/23/2011,8/23/2011,8/24/2011,1,0,1
8/23/2011,8/23/2011,8/24/2011,1,0,1
8/23/2011,8/23/2011,8/30/2011,7,0,7
8/23/2011,8/23/2011,8/29/2011,6,0,6
8/23/2011,8/23/2011,8/30/2011,7,0,7
8/23/2011,8/23/2011,8/30/2011,7,0,7
8/23/2011,8/23/2011,8/31/2011,8,0,8
8/23/2011,8/23/2011,10/24/2011,62,0,62
8/23/2011,8/23/2011,8/24/2011,1,0,1
8/24/2011,8/24/2011,8/25/2011,1,0,1
8/24/2011,8/24/2011,8/25/2011,1,0,1
8/24/2011,8/24/2011,8/25/2011,1,0,1
8/24/2011,8/24/2011,8/25/2011,1,0,1
8/25/2011,8/25/2011,9/6/2011,12,0,12
8/25/2011,8/25/2011,9/1/2011,7,0,7
8/25/2011,8/25/2011,8/31/2011,6,0,6
8/25/2011,8/25/2011,8/26/2011,1,0,1
8/25/2011,8/25/2011,8/26/2011,1,0,1
8/25/2011,8/25/2011,8/26/2011,1,0,1
8/25/2011,8/25/2011,9/6/2011,12,0,12
8/25/2011,8/25/2011,9/1/2011,7,0,7
8/26/2011,8/26/2011,9/30/2011,35,0,35
8/25/2011,8/25/2011,8/26/2011,1,0,1
8/25/2011,8/25/2011,8/26/2011,1,0,1
8/25/2011,8/25/2011,8/26/2011,1,0,1
8/25/2011,8/25/2011,9/1/2011,7,0,7
8/25/2011,8/25/2011,8/26/2011,1,0,1
8/26/2011,8/26/2011,8/29/2011,3,0,3
8/26/2011,8/26/2011,8/29/2011,3,0,3
9/7/2011,9/7/2011,9/13/2011,6,0,6
9/7/2011,9/7/2011,9/15/2011,8,0,8
9/7/2011,9/7/2011,9/15/2011,8,0,8
9/7/2011,9/7/2011,9/19/2011,12,0,12
9/7/2011,9/7/2011,9/8/2011,1,0,1
9/7/2011,9/7/2011,9/8/2011,1,0,1
9/7/2011,9/7/2011,9/8/2011,1,0,1
9/7/2011,9/7/2011,9/8/2011,1,0,1
9/7/2011,9/7/2011,9/8/2011,1,0,1
9/7/2011,9/7/2011,9/8/2011,1,0,1
9/7/2011,9/7/2011,10/7/2011,30,0,30
9/9/2011,9/8/2011,9/19/2011,11,-1,10
9/8/2011,9/8/2011,9/30/2011,22,0,22
9/8/2011,9/8/2011,10/12/2011,34,0,34
9/8/2011,9/8/2011,9/9/2011,1,0,1
9/8/2011,9/8/2011,9/9/2011,1,0,1
9/8/2011,9/8/2011,9/9/2011,1,0,1
9/8/2011,9/8/2011,9/9/2011,1,0,1
9/8/2011,9/8/2011,9/9/2011,1,0,1
9/22/2011,9/22/2011,10/4/2011,12,0,12
9/22/2011,9/22/2011,10/4/2011,12,0,12
9/22/2011,9/22/2011,9/12/2011,-10,0,-10
9/9/2011,9/9/2011,9/14/2011,5,0,5
9/9/2011,9/9/2011,9/15/2011,6,0,6
9/9/2011,9/9/2011,9/14/2011,5,0,5
9/9/2011,9/9/2011,9/21/2011,12,0,12
9/9/2011,9/9/2011,9/12/2011,3,0,3
9/9/2011,9/9/2011,9/12/2011,3,0,3
9/9/2011,9/9/2011,9/12/2011,3,0,3
9/9/2011,9/9/2011,9/12/2011,3,0,3
9/9/2011,9/9/2011,9/12/2011,3,0,3
9/9/2011,9/9/2011,10/12/2011,33,0,33
9/9/2011,9/9/2011,9/20/2011,11,0,11
9/22/2011,9/22/2011,10/10/2011,18,0,18
8/17/2011,8/17/2011,9/16/2011,30,0,30
8/29/2011,8/29/2011,8/30/2011,1,0,1
8/29/2011,8/29/2011,8/30/2011,1,0,1
8/30/2011,8/30/2011,9/6/2011,7,0,7
8/30/2011,8/30/2011,9/6/2011,7,0,7
8/30/2011,8/30/2011,9/6/2011,7,0,7
8/30/2011,8/30/2011,8/31/2011,1,0,1
8/30/2011,8/30/2011,8/31/2011,1,0,1
8/30/2011,8/30/2011,8/31/2011,1,0,1
8/30/2011,8/30/2011,8/31/2011,1,0,1
8/30/2011,8/30/2011,9/6/2011,7,0,7
8/30/2011,8/30/2011,9/2/2011,3,0,3
8/30/2011,8/30/2011,9/13/2011,14,0,14
8/31/2011,8/31/2011,9/6/2011,6,0,6
8/31/2011,8/31/2011,9/20/2011,20,0,20
9/2/2011,9/2/2011,9/13/2011,11,0,11
9/2/2011,9/2/2011,9/7/2011,5,0,5
9/2/2011,9/2/2011,9/7/2011,5,0,5
9/1/2011,8/31/2011,9/1/2011,1,-1,0
8/31/2011,8/31/2011,9/1/2011,1,0,1
8/31/2011,8/31/2011,9/1/2011,1,0,1
8/31/2011,8/31/2011,9/9/2011,9,0,9
8/31/2011,8/31/2011,9/1/2011,1,0,1
8/31/2011,8/31/2011,9/14/2011,14,0,14
9/2/2011,9/2/2011,9/7/2011,5,0,5
9/2/2011,9/2/2011,9/6/2011,4,0,4
9/2/2011,9/2/2011,9/6/2011,4,0,4
9/2/2011,9/2/2011,9/6/2011,4,0,4
9/2/2011,9/2/2011,9/6/2011,4,0,4
9/2/2011,9/2/2011,9/6/2011,4,0,4
9/2/2011,9/2/2011,9/6/2011,4,0,4
9/2/2011,9/2/2011,9/16/2011,14,0,14
9/2/2011,9/2/2011,9/20/2011,18,0,18
9/2/2011,9/2/2011,9/20/2011,18,0,18
8/19/2011,8/19/2011,9/19/2011,31,0,31
8/19/2011,8/19/2011,9/19/2011,31,0,31
9/6/2011,9/6/2011,9/20/2011,14,0,14
9/6/2011,9/6/2011,9/20/2011,14,0,14
8/22/2011,8/22/2011,8/23/2011,1,0,1
8/22/2011,8/22/2011,8/23/2011,1,0,1
8/22/2011,8/22/2011,8/23/2011,1,0,1
9/6/2011,9/6/2011,9/16/2011,10,0,10
9/6/2011,9/6/2011,9/16/2011,10,0,10
9/6/2011,9/6/2011,9/9/2011,3,0,3
9/12/2011,9/12/2011,9/16/2011,4,0,4
9/12/2011,9/12/2011,10/12/2011,30,0,30
9/12/2011,9/12/2011,9/13/2011,1,0,1
9/14/2011,9/12/2011,10/12/2011,30,-2,28
9/14/2011,9/12/2011,10/12/2011,30,-2,28
9/12/2011,9/12/2011,10/12/2011,30,0,30
9/14/2011,9/12/2011,9/21/2011,9,-2,7
9/12/2011,9/12/2011,9/13/2011,1,0,1
9/12/2011,9/12/2011,9/13/2011,1,0,1
9/12/2011,9/12/2011,9/13/2011,1,0,1
9/12/2011,9/12/2011,9/13/2011,1,0,1
9/12/2011,9/12/2011,9/13/2011,1,0,1
9/12/2011,9/12/2011,9/13/2011,1,0,1
9/12/2011,9/12/2011,9/19/2011,7,0,7
9/13/2011,9/13/2011,9/14/2011,1,0,1
9/13/2011,9/13/2011,9/14/2011,1,0,1
9/13/2011,9/13/2011,9/14/2011,1,0,1
9/13/2011,9/13/2011,9/14/2011,1,0,1
9/13/2011,9/13/2011,9/26/2011,13,0,13
9/13/2011,9/13/2011,9/14/2011,1,0,1
9/13/2011,9/13/2011,9/14/2011,1,0,1
9/13/2011,9/13/2011,9/20/2011,7,0,7
9/14/2011,9/14/2011,9/15/2011,1,0,1
9/16/2011,9/14/2011,10/17/2011,33,-2,31
9/14/2011,9/14/2011,9/15/2011,1,0,1
9/14/2011,9/14/2011,9/15/2011,1,0,1
9/14/2011,9/14/2011,9/15/2011,1,0,1
9/14/2011,9/14/2011,9/15/2011,1,0,1
9/14/2011,9/14/2011,9/15/2011,1,0,1
9/15/2011,9/15/2011,9/16/2011,1,0,1
9/15/2011,9/15/2011,9/16/2011,1,0,1
9/15/2011,9/15/2011,9/16/2011,1,0,1
9/15/2011,9/15/2011,9/16/2011,1,0,1
9/15/2011,9/15/2011,9/16/2011,1,0,1
9/20/2011,9/16/2011,9/27/2011,11,-4,7
9/16/2011,9/16/2011,9/19/2011,3,0,3
9/16/2011,9/16/2011,9/19/2011,3,0,3
9/16/2011,9/16/2011,9/19/2011,3,0,3
9/16/2011,9/16/2011,9/19/2011,3,0,3
9/16/2011,9/16/2011,9/19/2011,3,0,3
9/16/2011,9/16/2011,9/19/2011,3,0,3
9/16/2011,9/16/2011,9/19/2011,3,0,3
9/16/2011,9/16/2011,9/19/2011,3,0,3
8/15/2011,8/15/2011,8/30/2011,15,0,15
8/15/2011,8/15/2011,8/16/2011,1,0,1
8/15/2011,8/15/2011,8/16/2011,1,0,1
8/15/2011,8/15/2011,8/16/2011,1,0,1
8/15/2011,8/15/2011,8/16/2011,1,0,1
8/16/2011,8/16/2011,8/17/2011,1,0,1
8/16/2011,8/16/2011,8/17/2011,1,0,1
8/16/2011,8/16/2011,8/23/2011,7,0,7
8/16/2011,8/16/2011,8/22/2011,6,0,6
8/16/2011,8/16/2011,8/22/2011,6,0,6
8/16/2011,8/16/2011,8/17/2011,1,0,1
8/16/2011,8/16/2011,8/17/2011,1,0,1
8/17/2011,8/17/2011,8/23/2011,6,0,6
8/17/2011,8/17/2011,8/18/2011,1,0,1
8/17/2011,8/17/2011,8/18/2011,1,0,1
8/17/2011,8/17/2011,8/18/2011,1,0,1
8/18/2011,8/18/2011,8/24/2011,6,0,6
8/18/2011,8/18/2011,8/31/2011,13,0,13
8/18/2011,8/18/2011,8/19/2011,1,0,1
8/19/2011,8/18/2011,9/19/2011,32,-1,31
8/18/2011,8/18/2011,8/19/2011,1,0,1
8/18/2011,8/18/2011,8/19/2011,1,0,1
8/18/2011,8/18/2011,8/19/2011,1,0,1
8/18/2011,8/18/2011,8/19/2011,1,0,1
8/18/2011,8/18/2011,9/1/2011,14,0,14
8/19/2011,8/19/2011,9/2/2011,14,0,14
8/19/2011,8/19/2011,8/25/2011,6,0,6
8/19/2011,8/19/2011,8/30/2011,11,0,11
8/19/2011,8/19/2011,8/22/2011,3,0,3
8/26/2011,8/26/2011,8/29/2011,3,0,3
8/26/2011,8/26/2011,8/29/2011,3,0,3
8/26/2011,8/26/2011,8/30/2011,4,0,4
8/26/2011,8/26/2011,8/30/2011,4,0,4
8/26/2011,8/26/2011,9/7/2011,12,0,12
8/10/2011,8/10/2011,8/29/2011,19,0,19
8/11/2011,8/11/2011,8/17/2011,6,0,6
8/11/2011,8/11/2011,8/17/2011,6,0,6
8/11/2011,8/11/2011,8/29/2011,18,0,18
8/11/2011,8/11/2011,8/15/2011,4,0,4
8/11/2011,8/11/2011,8/12/2011,1,0,1
8/11/2011,8/11/2011,8/12/2011,1,0,1
8/11/2011,8/11/2011,8/12/2011,1,0,1
8/11/2011,8/11/2011,8/25/2011,14,0,14
8/11/2011,8/11/2011,8/22/2011,11,0,11
8/12/2011,8/11/2011,8/25/2011,14,-1,13
8/11/2011,8/11/2011,8/22/2011,11,0,11
8/12/2011,8/11/2011,8/18/2011,7,-1,6
8/12/2011,8/12/2011,9/12/2011,31,0,31
8/12/2011,8/12/2011,9/12/2011,31,0,31
8/12/2011,8/12/2011,9/12/2011,31,0,31
8/12/2011,8/12/2011,8/16/2011,4,0,4
8/16/2011,8/12/2011,9/14/2011,33,-4,29
8/17/2011,8/12/2011,8/18/2011,6,-5,1
8/17/2011,8/12/2011,9/14/2011,33,-5,28
8/17/2011,8/12/2011,8/31/2011,19,-5,14
8/12/2011,8/12/2011,8/15/2011,3,0,3
8/12/2011,8/12/2011,8/30/2011,18,0,18
8/12/2011,8/12/2011,8/15/2011,3,0,3
8/15/2011,8/15/2011,9/15/2011,31,0,31
8/15/2011,8/15/2011,9/15/2011,31,0,31
8/15/2011,8/15/2011,9/15/2011,31,0,31
8/16/2011,8/16/2011,9/16/2011,31,0,31
8/16/2011,8/16/2011,9/16/2011,31,0,31
8/26/2011,8/26/2011,8/29/2011,3,0,3
8/26/2011,8/26/2011,8/29/2011,3,0,3
8/26/2011,8/26/2011,8/29/2011,3,0,3
8/26/2011,8/26/2011,9/2/2011,7,0,7
8/29/2011,8/29/2011,11/25/2011,88,0,88
8/29/2011,8/29/2011,8/30/2011,1,0,1
8/23/2011,8/19/2011,8/30/2011,11,-4,7
8/23/2011,8/19/2011,9/23/2011,35,-4,31
8/19/2011,8/19/2011,8/22/2011,3,0,3
8/19/2011,8/19/2011,8/26/2011,7,0,7
8/19/2011,8/19/2011,8/22/2011,3,0,3
8/19/2011,8/19/2011,8/22/2011,3,0,3
8/19/2011,8/19/2011,8/22/2011,3,0,3
8/19/2011,8/19/2011,8/22/2011,3,0,3
8/22/2011,8/22/2011,8/23/2011,1,0,1
8/22/2011,8/22/2011,8/23/2011,1,0,1
8/29/2011,8/29/2011,8/30/2011,1,0,1
9/1/2011,8/31/2011,9/1/2011,1,-1,0
9/1/2011,8/31/2011,9/1/2011,1,-1,0
9/1/2011,9/1/2011,9/8/2011,7,0,7
9/1/2011,9/1/2011,9/2/2011,1,0,1
9/1/2011,9/1/2011,9/2/2011,1,0,1
9/1/2011,9/1/2011,9/2/2011,1,0,1
9/1/2011,9/1/2011,9/2/2011,1,0,1
9/1/2011,9/1/2011,9/2/2011,1,0,1
9/2/2011,9/2/2011,9/16/2011,14,0,14
9/22/2011,9/22/2011,10/4/2011,12,0,12
9/22/2011,9/22/2011,10/4/2011,12,0,12
9/22/2011,9/22/2011,9/12/2011,-10,0,-10
9/6/2011,9/6/2011,9/7/2011,1,0,1
9/6/2011,9/6/2011,9/7/2011,1,0,1
9/6/2011,9/6/2011,9/7/2011,1,0,1
9/6/2011,9/6/2011,9/7/2011,1,0,1
9/6/2011,9/6/2011,9/13/2011,7,0,7
9/6/2011,9/6/2011,9/20/2011,14,0,14
9/6/2011,9/6/2011,9/7/2011,1,0,1
9/6/2011,9/6/2011,9/13/2011,7,0,7
9/6/2011,9/6/2011,9/13/2011,7,0,7
9/6/2011,9/6/2011,9/15/2011,9,0,9
9/6/2011,9/6/2011,9/15/2011,9,0,9
9/6/2011,9/6/2011,9/19/2011,13,0,13
9/7/2011,9/7/2011,9/13/2011,6,0,6
9/7/2011,9/7/2011,9/13/2011,6,0,6
9/22/2011,9/22/2011,9/23/2011,1,0,1
9/26/2011,9/26/2011,9/27/2011,1,0,1
9/26/2011,9/26/2011,9/27/2011,1,0,1
9/26/2011,9/26/2011,9/27/2011,1,0,1
9/26/2011,9/26/2011,9/27/2011,1,0,1
9/26/2011,9/26/2011,9/27/2011,1,0,1
9/27/2011,9/27/2011,10/5/2011,8,0,8
9/27/2011,9/27/2011,9/28/2011,1,0,1
9/28/2011,9/28/2011,10/6/2011,8,0,8
9/28/2011,9/28/2011,10/21/2011,23,0,23
9/29/2011,9/29/2011,9/30/2011,1,0,1
10/3/2011,9/29/2011,10/10/2011,11,-4,7
9/29/2011,9/29/2011,10/21/2011,22,0,22
9/29/2011,9/29/2011,9/30/2011,1,0,1
9/29/2011,9/29/2011,9/30/2011,1,0,1
9/29/2011,9/29/2011,9/30/2011,1,0,1
9/29/2011,9/29/2011,9/30/2011,1,0,1
9/29/2011,9/29/2011,9/30/2011,1,0,1
9/29/2011,9/29/2011,9/30/2011,1,0,1
9/30/2011,9/30/2011,10/3/2011,3,0,3
9/30/2011,9/30/2011,10/3/2011,3,0,3
9/30/2011,9/30/2011,10/3/2011,3,0,3
9/30/2011,9/30/2011,10/3/2011,3,0,3
9/30/2011,9/30/2011,10/3/2011,3,0,3
10/4/2011,10/4/2011,10/5/2011,1,0,1
10/5/2011,10/4/2011,10/12/2011,8,-1,7
10/4/2011,10/4/2011,10/5/2011,1,0,1
10/4/2011,10/4/2011,10/5/2011,1,0,1
10/4/2011,10/4/2011,10/5/2011,1,0,1
10/4/2011,10/4/2011,10/5/2011,1,0,1
10/4/2011,10/4/2011,10/5/2011,1,0,1
10/5/2011,10/5/2011,10/6/2011,1,0,1
10/5/2011,10/5/2011,10/6/2011,1,0,1
10/5/2011,10/5/2011,10/6/2011,1,0,1
10/5/2011,10/5/2011,10/12/2011,7,0,7
10/5/2011,10/5/2011,10/6/2011,1,0,1
9/16/2011,9/16/2011,9/19/2011,3,0,3
9/16/2011,9/16/2011,9/19/2011,3,0,3
10/3/2011,10/3/2011,10/12/2011,9,0,9
10/3/2011,10/3/2011,10/12/2011,9,0,9
10/4/2011,10/4/2011,10/12/2011,8,0,8
10/4/2011,10/4/2011,10/10/2011,6,0,6
10/4/2011,10/4/2011,11/3/2011,30,0,30
10/4/2011,10/4/2011,11/3/2011,30,0,30
10/6/2011,10/6/2011,10/7/2011,1,0,1
10/4/2011,10/4/2011,10/13/2011,9,0,9
10/5/2011,10/5/2011,10/6/2011,1,0,1
10/6/2011,10/6/2011,10/7/2011,1,0,1
10/6/2011,10/6/2011,10/7/2011,1,0,1
10/6/2011,10/6/2011,10/7/2011,1,0,1
10/7/2011,10/6/2011,11/7/2011,32,-1,31
10/10/2011,10/6/2011,10/17/2011,11,-4,7
10/7/2011,10/7/2011,10/10/2011,3,0,3
10/7/2011,10/7/2011,11/7/2011,31,0,31
10/11/2011,10/7/2011,10/18/2011,11,-4,7
10/7/2011,10/7/2011,10/11/2011,4,0,4
10/7/2011,10/7/2011,10/11/2011,4,0,4
10/7/2011,10/7/2011,10/11/2011,4,0,4
10/7/2011,10/7/2011,10/10/2011,3,0,3
10/10/2011,10/10/2011,10/17/2011,7,0,7
10/12/2011,10/11/2011,11/14/2011,34,-1,33
10/12/2011,10/11/2011,10/19/2011,8,-1,7
10/11/2011,10/11/2011,10/12/2011,1,0,1
10/11/2011,10/11/2011,10/12/2011,1,0,1
10/11/2011,10/11/2011,10/12/2011,1,0,1
10/11/2011,10/11/2011,10/13/2011,2,0,2
10/11/2011,10/11/2011,10/12/2011,1,0,1
10/11/2011,10/11/2011,10/12/2011,1,0,1
10/11/2011,10/11/2011,10/12/2011,1,0,1
10/12/2011,10/12/2011,10/13/2011,1,0,1
10/12/2011,10/12/2011,10/13/2011,1,0,1
10/12/2011,10/12/2011,10/13/2011,1,0,1
10/12/2011,10/12/2011,10/13/2011,1,0,1
10/12/2011,10/12/2011,10/13/2011,1,0,1
10/12/2011,10/12/2011,10/13/2011,1,0,1
10/13/2011,10/13/2011,10/18/2011,5,0,5
10/13/2011,10/13/2011,10/27/2011,14,0,14
10/17/2011,10/13/2011,11/17/2011,35,-4,31
10/17/2011,10/13/2011,10/18/2011,5,-4,1
10/6/2011,10/6/2011,10/7/2011,1,0,1
10/6/2011,10/6/2011,10/7/2011,1,0,1
10/6/2011,10/6/2011,10/7/2011,1,0,1
10/10/2011,10/10/2011,10/11/2011,1,0,1
10/10/2011,10/10/2011,10/11/2011,1,0,1
10/10/2011,10/10/2011,10/11/2011,1,0,1
10/11/2011,10/11/2011,11/7/2011,27,0,27
10/11/2011,10/11/2011,11/7/2011,27,0,27
10/12/2011,10/11/2011,10/19/2011,8,-1,7
10/14/2011,10/14/2011,12/5/2011,52,0,52
10/14/2011,10/14/2011,10/17/2011,3,0,3
10/14/2011,10/14/2011,10/17/2011,3,0,3
10/18/2011,10/14/2011,10/25/2011,11,-4,7
10/17/2011,10/17/2011,11/15/2011,29,0,29
10/17/2011,10/17/2011,10/25/2011,8,0,8
10/17/2011,10/17/2011,10/24/2011,7,0,7
10/19/2011,10/17/2011,11/21/2011,35,-2,33
10/19/2011,10/17/2011,10/26/2011,9,-2,7
10/17/2011,10/17/2011,10/28/2011,11,0,11
10/17/2011,10/17/2011,10/18/2011,1,0,1
10/17/2011,10/17/2011,10/18/2011,1,0,1
10/17/2011,10/17/2011,10/18/2011,1,0,1
10/17/2011,10/17/2011,10/18/2011,1,0,1
10/17/2011,10/17/2011,10/18/2011,1,0,1
10/18/2011,10/18/2011,11/16/2011,29,0,29
10/18/2011,10/18/2011,11/16/2011,29,0,29
10/18/2011,10/18/2011,10/19/2011,1,0,1
10/19/2011,10/18/2011,10/26/2011,8,-1,7
10/18/2011,10/18/2011,10/19/2011,1,0,1
10/18/2011,10/18/2011,10/19/2011,1,0,1
10/18/2011,10/18/2011,10/19/2011,1,0,1
10/18/2011,10/18/2011,10/19/2011,1,0,1
10/18/2011,10/18/2011,10/19/2011,1,0,1
10/18/2011,10/18/2011,10/19/2011,1,0,1
10/19/2011,10/19/2011,11/21/2011,33,0,33
10/19/2011,10/19/2011,10/26/2011,7,0,7
10/19/2011,10/19/2011,10/26/2011,7,0,7
9/22/2011,9/22/2011,10/12/2011,20,0,20
9/22/2011,9/22/2011,9/19/2011,-3,0,-3
9/22/2011,9/22/2011,10/17/2011,25,0,25
9/22/2011,9/22/2011,9/22/2011,0,0,0
9/22/2011,9/22/2011,10/18/2011,26,0,26
9/22/2011,9/22/2011,10/18/2011,26,0,26
9/22/2011,9/22/2011,9/23/2011,1,0,1
9/22/2011,9/22/2011,10/19/2011,27,0,27
9/22/2011,9/22/2011,9/26/2011,4,0,4
9/22/2011,9/22/2011,9/26/2011,4,0,4
9/22/2011,9/22/2011,9/29/2011,7,0,7
9/22/2011,9/22/2011,10/11/2011,19,0,19
9/22/2011,9/22/2011,10/11/2011,19,0,19
9/22/2011,9/22/2011,9/14/2011,-8,0,-8
9/22/2011,9/22/2011,10/12/2011,20,0,20
9/22/2011,9/22/2011,9/19/2011,-3,0,-3
9/22/2011,9/22/2011,9/21/2011,-1,0,-1
9/22/2011,9/22/2011,9/28/2011,6,0,6
9/22/2011,9/22/2011,9/29/2011,7,0,7
10/17/2011,10/17/2011,10/24/2011,7,0,7
10/19/2011,10/19/2011,10/20/2011,1,0,1
10/19/2011,10/19/2011,10/20/2011,1,0,1
10/19/2011,10/19/2011,10/20/2011,1,0,1
10/19/2011,10/19/2011,10/20/2011,1,0,1
10/19/2011,10/19/2011,10/20/2011,1,0,1
10/19/2011,10/19/2011,10/20/2011,1,0,1
10/19/2011,10/19/2011,10/20/2011,1,0,1
10/20/2011,10/20/2011,10/31/2011,11,0,11
10/20/2011,10/20/2011,10/31/2011,11,0,11
10/20/2011,10/20/2011,10/21/2011,1,0,1
10/20/2011,10/20/2011,11/24/2011,35,0,35
10/20/2011,10/20/2011,10/21/2011,1,0,1
10/20/2011,10/20/2011,10/21/2011,1,0,1
10/20/2011,10/20/2011,10/21/2011,1,0,1
10/20/2011,10/20/2011,10/21/2011,1,0,1
10/20/2011,10/20/2011,10/21/2011,1,0,1
9/22/2011,9/22/2011,9/30/2011,8,0,8
9/26/2011,9/26/2011,9/27/2011,1,0,1
9/27/2011,9/27/2011,10/3/2011,6,0,6
9/27/2011,9/27/2011,9/28/2011,1,0,1
9/27/2011,9/27/2011,9/28/2011,1,0,1
9/27/2011,9/27/2011,9/28/2011,1,0,1
9/27/2011,9/27/2011,9/28/2011,1,0,1
9/27/2011,9/27/2011,9/28/2011,1,0,1
9/28/2011,9/28/2011,9/29/2011,1,0,1
9/27/2011,9/27/2011,9/28/2011,1,0,1
9/27/2011,9/27/2011,9/28/2011,1,0,1
9/27/2011,9/27/2011,9/28/2011,1,0,1
9/30/2011,9/28/2011,10/28/2011,30,-2,28
9/28/2011,9/28/2011,10/28/2011,30,0,30
10/3/2011,9/28/2011,10/28/2011,30,-5,25
9/28/2011,9/28/2011,10/11/2011,13,0,13
9/28/2011,9/28/2011,9/29/2011,1,0,1
9/28/2011,9/28/2011,9/29/2011,1,0,1
9/28/2011,9/28/2011,9/29/2011,1,0,1
9/28/2011,9/28/2011,9/29/2011,1,0,1
9/28/2011,9/28/2011,9/29/2011,1,0,1
9/28/2011,9/28/2011,9/29/2011,1,0,1
9/28/2011,9/28/2011,9/29/2011,1,0,1
10/4/2011,10/4/2011,10/11/2011,7,0,7
10/6/2011,10/4/2011,10/13/2011,9,-2,7
10/12/2011,10/12/2011,11/14/2011,33,0,33
10/12/2011,10/12/2011,11/14/2011,33,0,33
10/12/2011,10/12/2011,10/19/2011,7,0,7
10/12/2011,10/12/2011,11/14/2011,33,0,33
10/12/2011,10/12/2011,10/19/2011,7,0,7
10/21/2011,10/21/2011,11/1/2011,11,0,11
10/25/2011,10/21/2011,10/31/2011,10,-4,6
10/21/2011,10/21/2011,10/24/2011,3,0,3
10/21/2011,10/21/2011,10/24/2011,3,0,3
10/21/2011,10/21/2011,10/24/2011,3,0,3
10/21/2011,10/21/2011,10/24/2011,3,0,3
10/21/2011,10/21/2011,10/24/2011,3,0,3
9/22/2011,9/22/2011,9/23/2011,1,0,1
9/22/2011,9/22/2011,9/23/2011,1,0,1
9/22/2011,9/22/2011,9/23/2011,1,0,1
9/29/2011,9/29/2011,10/7/2011,8,0,8
9/23/2011,9/23/2011,9/26/2011,3,0,3
9/23/2011,9/23/2011,9/26/2011,3,0,3
9/23/2011,9/23/2011,9/26/2011,3,0,3
9/23/2011,9/23/2011,9/26/2011,3,0,3
9/23/2011,9/23/2011,9/26/2011,3,0,3
9/23/2011,9/23/2011,9/26/2011,3,0,3
9/23/2011,9/23/2011,9/26/2011,3,0,3
9/23/2011,9/23/2011,9/26/2011,3,0,3
9/23/2011,9/23/2011,9/26/2011,3,0,3
10/3/2011,10/3/2011,10/12/2011,9,0,9
10/3/2011,10/3/2011,10/4/2011,1,0,1
10/3/2011,10/3/2011,10/4/2011,1,0,1
10/3/2011,10/3/2011,10/4/2011,1,0,1
10/3/2011,10/3/2011,10/4/2011,1,0,1
10/3/2011,10/3/2011,10/4/2011,1,0,1
10/3/2011,10/3/2011,10/4/2011,1,0,1
10/3/2011,10/3/2011,10/4/2011,1,0,1
10/4/2011,10/4/2011,11/3/2011,30,0,30
10/4/2011,10/4/2011,11/3/2011,30,0,30
10/4/2011,10/4/2011,10/10/2011,6,0,6
10/5/2011,10/5/2011,10/21/2011,16,0,16
10/5/2011,10/5/2011,11/8/2011,34,0,34
10/5/2011,10/5/2011,10/6/2011,1,0,1
10/5/2011,10/5/2011,10/6/2011,1,0,1
10/5/2011,10/5/2011,10/6/2011,1,0,1
10/5/2011,10/5/2011,10/6/2011,1,0,1
10/6/2011,10/6/2011,10/10/2011,4,0,4
10/10/2011,10/10/2011,11/10/2011,31,0,31
10/10/2011,10/10/2011,11/10/2011,31,0,31
10/12/2011,10/12/2011,10/17/2011,5,0,5
10/13/2011,10/13/2011,10/14/2011,1,0,1
10/13/2011,10/13/2011,10/14/2011,1,0,1
10/13/2011,10/13/2011,10/14/2011,1,0,1
10/13/2011,10/13/2011,10/14/2011,1,0,1
10/13/2011,10/13/2011,10/14/2011,1,0,1
10/13/2011,10/13/2011,10/14/2011,1,0,1
10/14/2011,10/14/2011,10/17/2011,3,0,3
10/14/2011,10/14/2011,10/17/2011,3,0,3
10/14/2011,10/14/2011,10/17/2011,3,0,3
10/14/2011,10/14/2011,10/17/2011,3,0,3
10/14/2011,10/14/2011,10/17/2011,3,0,3
10/14/2011,10/14/2011,10/17/2011,3,0,3
9/26/2011,9/22/2011,10/4/2011,12,-4,8
9/19/2011,9/19/2011,9/19/2011,0,0,0
9/19/2011,9/19/2011,9/19/2011,0,0,0
9/19/2011,9/19/2011,10/14/2011,25,0,25
9/19/2011,9/19/2011,10/24/2011,35,0,35
9/19/2011,9/19/2011,9/21/2011,2,0,2
9/19/2011,9/19/2011,9/21/2011,2,0,2
9/19/2011,9/19/2011,9/26/2011,7,0,7
9/19/2011,9/19/2011,9/20/2011,1,0,1
9/19/2011,9/19/2011,9/20/2011,1,0,1
9/19/2011,9/19/2011,9/20/2011,1,0,1
9/19/2011,9/19/2011,9/20/2011,1,0,1
9/19/2011,9/19/2011,9/20/2011,1,0,1
9/20/2011,9/20/2011,10/12/2011,22,0,22
9/20/2011,9/20/2011,9/26/2011,6,0,6
9/20/2011,9/20/2011,9/21/2011,1,0,1
9/20/2011,9/20/2011,9/21/2011,1,0,1
9/20/2011,9/20/2011,9/21/2011,1,0,1
9/20/2011,9/20/2011,9/21/2011,1,0,1
9/20/2011,9/20/2011,9/21/2011,1,0,1
9/20/2011,9/20/2011,9/21/2011,1,0,1
9/20/2011,9/20/2011,9/21/2011,1,0,1
9/21/2011,9/21/2011,10/3/2011,12,0,12
9/21/2011,9/21/2011,9/22/2011,1,0,1
9/21/2011,9/21/2011,9/22/2011,1,0,1
9/22/2011,9/22/2011,10/4/2011,12,0,12
9/22/2011,9/22/2011,9/23/2011,1,0,1
9/22/2011,9/22/2011,9/28/2011,6,0,6
9/22/2011,9/22/2011,9/23/2011,1,0,1
9/22/2011,9/22/2011,9/23/2011,1,0,1
11/21/2011,11/21/2011,11/28/2011,7,0,7
11/28/2011,11/28/2011,11/29/2011,1,0,1
11/28/2011,11/28/2011,11/29/2011,1,0,1
11/28/2011,11/28/2011,11/29/2011,1,0,1
11/28/2011,11/28/2011,11/29/2011,1,0,1
11/28/2011,11/28/2011,11/29/2011,1,0,1
11/29/2011,11/29/2011,11/30/2011,1,0,1
11/29/2011,11/29/2011,11/30/2011,1,0,1
11/29/2011,11/29/2011,11/30/2011,1,0,1
11/29/2011,11/29/2011,11/30/2011,1,0,1
11/29/2011,11/29/2011,11/30/2011,1,0,1
11/29/2011,11/29/2011,11/30/2011,1,0,1
11/29/2011,11/29/2011,11/30/2011,1,0,1
11/30/2011,11/30/2011,12/9/2011,9,0,9
12/2/2011,12/2/2011,12/12/2011,10,0,10
12/2/2011,12/2/2011,12/5/2011,3,0,3
12/5/2011,12/5/2011,12/6/2011,1,0,1
12/5/2011,12/5/2011,12/6/2011,1,0,1
12/6/2011,12/6/2011,12/7/2011,1,0,1
12/6/2011,12/6/2011,12/7/2011,1,0,1
12/6/2011,12/6/2011,12/7/2011,1,0,1
12/7/2011,12/7/2011,12/14/2011,7,0,7
12/7/2011,12/7/2011,12/8/2011,1,0,1
12/7/2011,12/7/2011,12/8/2011,1,0,1
12/7/2011,12/7/2011,12/14/2011,7,0,7
12/7/2011,12/7/2011,12/8/2011,1,0,1
12/7/2011,12/7/2011,12/8/2011,1,0,1
12/8/2011,12/8/2011,12/19/2011,11,0,11
12/12/2011,12/8/2011,12/19/2011,11,-4,7
12/8/2011,12/8/2011,12/9/2011,1,0,1
12/8/2011,12/8/2011,1/17/2012,40,0,40
12/8/2011,12/8/2011,12/9/2011,1,0,1
12/8/2011,12/8/2011,12/9/2011,1,0,1
12/8/2011,12/8/2011,12/9/2011,1,0,1
12/8/2011,12/8/2011,12/9/2011,1,0,1
12/8/2011,12/8/2011,12/9/2011,1,0,1
10/26/2011,10/25/2011,11/2/2011,8,-1,7
10/26/2011,10/25/2011,11/2/2011,8,-1,7
10/26/2011,10/25/2011,11/2/2011,8,-1,7
10/28/2011,10/28/2011,11/3/2011,6,0,6
10/28/2011,10/28/2011,11/8/2011,11,0,11
11/2/2011,11/2/2011,11/10/2011,8,0,8
11/2/2011,11/2/2011,11/9/2011,7,0,7
11/1/2011,11/1/2011,11/2/2011,1,0,1
11/1/2011,11/1/2011,11/8/2011,7,0,7
11/1/2011,11/1/2011,11/8/2011,7,0,7
11/1/2011,11/1/2011,11/2/2011,1,0,1
11/2/2011,11/2/2011,11/3/2011,1,0,1
11/2/2011,11/2/2011,11/3/2011,1,0,1
11/2/2011,11/2/2011,11/3/2011,1,0,1
11/2/2011,11/2/2011,11/3/2011,1,0,1
11/3/2011,11/3/2011,11/11/2011,8,0,8
11/3/2011,11/3/2011,11/4/2011,1,0,1
11/7/2011,11/7/2011,12/7/2011,30,0,30
11/7/2011,11/7/2011,12/7/2011,30,0,30
11/7/2011,11/7/2011,11/14/2011,7,0,7
11/7/2011,11/7/2011,11/8/2011,1,0,1
11/7/2011,11/7/2011,11/8/2011,1,0,1
11/7/2011,11/7/2011,11/8/2011,1,0,1
11/7/2011,11/7/2011,11/8/2011,1,0,1
11/7/2011,11/7/2011,11/8/2011,1,0,1
11/7/2011,11/7/2011,11/8/2011,1,0,1
11/8/2011,11/8/2011,11/9/2011,1,0,1
11/8/2011,11/8/2011,11/9/2011,1,0,1
11/8/2011,11/8/2011,11/9/2011,1,0,1
11/8/2011,11/8/2011,11/9/2011,1,0,1
11/8/2011,11/8/2011,11/9/2011,1,0,1
11/8/2011,11/8/2011,11/9/2011,1,0,1
11/8/2011,11/8/2011,11/9/2011,1,0,1
11/9/2011,11/8/2011,11/14/2011,6,-1,5
11/3/2011,11/3/2011,11/4/2011,1,0,1
11/3/2011,11/3/2011,11/4/2011,1,0,1
11/3/2011,11/3/2011,11/4/2011,1,0,1
11/3/2011,11/3/2011,11/4/2011,1,0,1
11/3/2011,11/3/2011,11/4/2011,1,0,1
11/4/2011,11/4/2011,11/7/2011,3,0,3
11/4/2011,11/4/2011,11/7/2011,3,0,3
11/4/2011,11/4/2011,11/7/2011,3,0,3
11/4/2011,11/4/2011,11/7/2011,3,0,3
11/4/2011,11/4/2011,11/7/2011,3,0,3
11/4/2011,11/4/2011,11/7/2011,3,0,3
11/4/2011,11/4/2011,11/17/2011,13,0,13
11/4/2011,11/4/2011,11/10/2011,6,0,6
11/9/2011,11/8/2011,11/14/2011,6,-1,5
11/8/2011,11/8/2011,11/15/2011,7,0,7
11/8/2011,11/8/2011,11/9/2011,1,0,1
11/8/2011,11/8/2011,11/9/2011,1,0,1
11/8/2011,11/8/2011,11/9/2011,1,0,1
11/14/2011,11/9/2011,12/14/2011,35,-5,30
11/14/2011,11/9/2011,1/16/2012,68,-5,63
11/14/2011,11/9/2011,2/14/2012,97,-5,92
11/9/2011,11/9/2011,11/10/2011,1,0,1
11/9/2011,11/9/2011,11/10/2011,1,0,1
11/9/2011,11/9/2011,11/10/2011,1,0,1
11/9/2011,11/9/2011,11/10/2011,1,0,1
11/9/2011,11/9/2011,11/10/2011,1,0,1
11/10/2011,11/10/2011,12/9/2011,29,0,29
11/10/2011,11/10/2011,11/17/2011,7,0,7
11/10/2011,11/10/2011,11/18/2011,8,0,8
11/10/2011,11/10/2011,11/14/2011,4,0,4
11/16/2011,11/14/2011,11/23/2011,9,-2,7
11/10/2011,11/10/2011,11/14/2011,4,0,4
11/10/2011,11/10/2011,11/14/2011,4,0,4
11/10/2011,11/10/2011,12/7/2011,27,0,27
11/10/2011,11/10/2011,11/14/2011,4,0,4
11/10/2011,11/10/2011,11/14/2011,4,0,4
11/10/2011,11/10/2011,11/14/2011,4,0,4
11/14/2011,11/14/2011,11/15/2011,1,0,1
11/14/2011,11/14/2011,11/15/2011,1,0,1
11/15/2011,11/15/2011,11/22/2011,7,0,7
11/14/2011,11/14/2011,11/15/2011,1,0,1
11/14/2011,11/14/2011,11/15/2011,1,0,1
11/14/2011,11/14/2011,11/15/2011,1,0,1
11/14/2011,11/14/2011,11/15/2011,1,0,1
11/15/2011,11/15/2011,11/21/2011,6,0,6
11/15/2011,11/15/2011,11/28/2011,13,0,13
11/15/2011,11/15/2011,11/16/2011,1,0,1
11/15/2011,11/15/2011,11/16/2011,1,0,1
11/15/2011,11/15/2011,11/16/2011,1,0,1
11/15/2011,11/15/2011,11/16/2011,1,0,1
11/15/2011,11/15/2011,11/16/2011,1,0,1
11/15/2011,11/15/2011,11/16/2011,1,0,1
11/16/2011,11/16/2011,12/16/2011,30,0,30
11/16/2011,11/16/2011,12/16/2011,30,0,30
11/16/2011,11/16/2011,11/23/2011,7,0,7
11/16/2011,11/16/2011,11/24/2011,8,0,8
11/17/2011,11/17/2011,11/18/2011,1,0,1
11/17/2011,11/17/2011,11/18/2011,1,0,1
11/17/2011,11/17/2011,11/18/2011,1,0,1
11/17/2011,11/17/2011,11/18/2011,1,0,1
11/18/2011,11/18/2011,11/21/2011,3,0,3
11/18/2011,11/18/2011,11/21/2011,3,0,3
11/18/2011,11/18/2011,11/21/2011,3,0,3
11/18/2011,11/18/2011,11/21/2011,3,0,3
11/21/2011,11/21/2011,11/22/2011,1,0,1
11/21/2011,11/21/2011,11/22/2011,1,0,1
11/21/2011,11/21/2011,11/22/2011,1,0,1
11/22/2011,11/22/2011,11/23/2011,1,0,1
11/22/2011,11/22/2011,11/23/2011,1,0,1
10/24/2011,10/24/2011,10/31/2011,7,0,7
10/24/2011,10/24/2011,10/25/2011,1,0,1
10/26/2011,10/24/2011,11/2/2011,9,-2,7
10/24/2011,10/24/2011,10/25/2011,1,0,1
10/24/2011,10/24/2011,10/25/2011,1,0,1
10/24/2011,10/24/2011,10/25/2011,1,0,1
10/25/2011,10/25/2011,10/31/2011,6,0,6
10/25/2011,10/25/2011,10/26/2011,1,0,1
10/25/2011,10/25/2011,10/26/2011,1,0,1
10/25/2011,10/25/2011,10/26/2011,1,0,1
10/25/2011,10/25/2011,11/1/2011,7,0,7
10/25/2011,10/25/2011,10/26/2011,1,0,1
10/25/2011,10/25/2011,10/26/2011,1,0,1
10/26/2011,10/26/2011,10/27/2011,1,0,1
10/28/2011,10/26/2011,11/28/2011,33,-2,31
10/26/2011,10/26/2011,10/27/2011,1,0,1
10/26/2011,10/26/2011,10/27/2011,1,0,1
10/26/2011,10/26/2011,10/27/2011,1,0,1
10/26/2011,10/26/2011,10/27/2011,1,0,1
10/26/2011,10/26/2011,10/27/2011,1,0,1
10/27/2011,10/27/2011,10/28/2011,1,0,1
10/27/2011,10/27/2011,10/28/2011,1,0,1
10/27/2011,10/27/2011,10/31/2011,4,0,4
10/27/2011,10/27/2011,10/28/2011,1,0,1
10/27/2011,10/27/2011,10/28/2011,1,0,1
10/28/2011,10/28/2011,10/31/2011,3,0,3
10/28/2011,10/28/2011,10/31/2011,3,0,3
10/28/2011,10/28/2011,10/31/2011,3,0,3
10/28/2011,10/28/2011,10/31/2011,3,0,3
10/28/2011,10/28/2011,10/31/2011,3,0,3
10/28/2011,10/28/2011,10/31/2011,3,0,3
10/31/2011,10/31/2011,11/7/2011,7,0,7
10/31/2011,10/31/2011,11/1/2011,1,0,1
10/31/2011,10/31/2011,11/1/2011,1,0,1
10/31/2011,10/31/2011,11/1/2011,1,0,1
10/31/2011,10/31/2011,11/1/2011,1,0,1
10/31/2011,10/31/2011,11/1/2011,1,0,1
11/1/2011,11/1/2011,11/9/2011,8,0,8
11/1/2011,11/1/2011,11/9/2011,8,0,8
11/1/2011,11/1/2011,11/9/2011,8,0,8
11/7/2011,11/7/2011,11/16/2011,9,0,9
11/7/2011,11/7/2011,11/15/2011,8,0,8
11/15/2011,11/15/2011,11/16/2011,1,0,1
11/17/2011,11/15/2011,12/19/2011,34,-2,32
11/15/2011,11/15/2011,11/16/2011,1,0,1
11/15/2011,11/15/2011,11/16/2011,1,0,1
11/16/2011,11/16/2011,11/23/2011,7,0,7
11/16/2011,11/16/2011,11/17/2011,1,0,1
11/16/2011,11/16/2011,11/23/2011,7,0,7
11/16/2011,11/16/2011,11/17/2011,1,0,1
11/16/2011,11/16/2011,11/17/2011,1,0,1
11/16/2011,11/16/2011,11/17/2011,1,0,1
11/16/2011,11/16/2011,11/17/2011,1,0,1
11/16/2011,11/16/2011,11/17/2011,1,0,1
11/16/2011,11/16/2011,11/17/2011,1,0,1
11/21/2011,11/17/2011,11/28/2011,11,-4,7
11/17/2011,11/17/2011,11/18/2011,1,0,1
11/21/2011,11/17/2011,11/28/2011,11,-4,7
11/17/2011,11/17/2011,11/18/2011,1,0,1
11/17/2011,11/17/2011,11/18/2011,1,0,1
11/17/2011,11/17/2011,11/18/2011,1,0,1
11/21/2011,11/21/2011,12/19/2011,28,0,28
11/21/2011,11/21/2011,11/28/2011,7,0,7
11/22/2011,11/22/2011,11/23/2011,1,0,1
10/31/2011,10/31/2011,11/8/2011,8,0,8
11/14/2011,11/14/2011,12/12/2011,28,0,28
11/22/2011,11/22/2011,11/23/2011,1,0,1
11/17/2011,11/17/2011,11/25/2011,8,0,8
11/17/2011,11/17/2011,11/25/2011,8,0,8
11/22/2011,11/22/2011,12/1/2011,9,0,9
11/24/2011,11/24/2011,12/2/2011,8,0,8
11/25/2011,11/25/2011,12/5/2011,10,0,10
11/25/2011,11/25/2011,12/6/2011,11,0,11
11/25/2011,11/25/2011,12/6/2011,11,0,11
11/25/2011,11/25/2011,11/28/2011,3,0,3
11/25/2011,11/25/2011,11/28/2011,3,0,3
11/25/2011,11/25/2011,11/28/2011,3,0,3
11/25/2011,11/25/2011,11/28/2011,3,0,3
11/25/2011,11/25/2011,11/28/2011,3,0,3
11/25/2011,11/25/2011,11/28/2011,3,0,3
11/25/2011,11/25/2011,11/28/2011,3,0,3
11/28/2011,11/28/2011,12/6/2011,8,0,8
11/28/2011,11/28/2011,11/29/2011,1,0,1
11/29/2011,11/29/2011,12/7/2011,8,0,8
11/30/2011,11/30/2011,12/13/2011,13,0,13
11/30/2011,11/30/2011,12/22/2011,22,0,22
11/30/2011,11/30/2011,12/1/2011,1,0,1
11/30/2011,11/30/2011,12/1/2011,1,0,1
11/30/2011,11/30/2011,12/1/2011,1,0,1
12/1/2011,12/1/2011,12/5/2011,4,0,4
12/1/2011,12/1/2011,12/5/2011,4,0,4
12/1/2011,12/1/2011,12/2/2011,1,0,1
12/1/2011,12/1/2011,12/2/2011,1,0,1
12/1/2011,12/1/2011,12/2/2011,1,0,1
12/1/2011,12/1/2011,12/2/2011,1,0,1
12/1/2011,12/1/2011,12/2/2011,1,0,1
12/1/2011,12/1/2011,12/2/2011,1,0,1
12/1/2011,12/1/2011,12/2/2011,1,0,1
12/1/2011,12/1/2011,12/2/2011,1,0,1
12/1/2011,12/1/2011,12/2/2011,1,0,1
12/1/2011,12/1/2011,12/8/2011,7,0,7
12/5/2011,12/2/2011,12/12/2011,10,-3,7
11/3/2011,11/3/2011,12/5/2011,32,0,32
11/3/2011,11/3/2011,12/5/2011,32,0,32
11/3/2011,11/3/2011,11/11/2011,8,0,8
11/14/2011,11/11/2011,11/22/2011,11,-3,8
11/21/2011,11/21/2011,12/1/2011,10,0,10
11/21/2011,11/21/2011,11/28/2011,7,0,7
11/21/2011,11/21/2011,11/22/2011,1,0,1
11/21/2011,11/21/2011,11/22/2011,1,0,1
11/23/2011,11/23/2011,11/24/2011,1,0,1
11/23/2011,11/23/2011,11/24/2011,1,0,1
11/23/2011,11/23/2011,11/25/2011,2,0,2
11/23/2011,11/23/2011,11/25/2011,2,0,2
11/23/2011,11/23/2011,11/25/2011,2,0,2
11/23/2011,11/23/2011,11/25/2011,2,0,2
11/23/2011,11/23/2011,11/25/2011,2,0,2
11/23/2011,11/23/2011,11/25/2011,2,0,2
11/24/2011,11/24/2011,11/25/2011,1,0,1
11/24/2011,11/24/2011,11/25/2011,1,0,1
12/2/2011,12/2/2011,12/5/2011,3,0,3
12/2/2011,12/2/2011,12/5/2011,3,0,3
12/2/2011,12/2/2011,12/5/2011,3,0,3
12/2/2011,12/2/2011,12/5/2011,3,0,3
12/2/2011,12/2/2011,12/5/2011,3,0,3
12/5/2011,12/5/2011,12/12/2011,7,0,7
12/5/2011,12/5/2011,12/12/2011,7,0,7
12/5/2011,12/5/2011,12/15/2011,10,0,10
12/5/2011,12/5/2011,12/15/2011,10,0,10
12/6/2011,12/5/2011,1/6/2012,32,-1,31
12/5/2011,12/5/2011,12/6/2011,1,0,1
12/5/2011,12/5/2011,12/6/2011,1,0,1
12/5/2011,12/5/2011,12/6/2011,1,0,1
12/5/2011,12/5/2011,12/6/2011,1,0,1
12/6/2011,12/6/2011,12/7/2011,1,0,1
12/6/2011,12/6/2011,12/7/2011,1,0,1
12/6/2011,12/6/2011,12/7/2011,1,0,1
4/22/2014,4/22/2014,4/29/2014,7,0,7
9/29/2014,9/26/2014,12/19/2014,84,-3,81
9/29/2014,9/26/2014,12/19/2014,84,-3,81
9/30/2014,9/26/2014,1/5/2015,101,-4,97
9/26/2014,9/26/2014,10/3/2014,7,0,7
9/30/2014,9/30/2014,10/7/2014,7,0,7
10/6/2014,10/1/2014,12/8/2014,68,-5,63
10/6/2014,10/6/2014,10/14/2014,8,0,8
10/8/2014,10/8/2014,11/5/2014,28,0,28
10/10/2014,10/10/2014,11/12/2014,33,0,33
10/15/2014,10/15/2014,11/14/2014,30,0,30
10/16/2014,10/16/2014,11/14/2014,29,0,29
10/17/2014,10/17/2014,11/17/2014,31,0,31
10/17/2014,10/17/2014,10/24/2014,7,0,7
10/17/2014,10/17/2014,10/24/2014,7,0,7
10/17/2014,10/17/2014,10/24/2014,7,0,7
10/21/2014,10/20/2014,11/24/2014,35,-1,34
10/21/2014,10/21/2014,10/28/2014,7,0,7
10/24/2014,10/24/2014,10/31/2014,7,0,7
10/24/2014,10/24/2014,10/31/2014,7,0,7
10/28/2014,10/28/2014,11/4/2014,7,0,7
10/29/2014,10/29/2014,12/1/2014,33,0,33
10/29/2014,10/29/2014,12/1/2014,33,0,33
10/30/2014,10/30/2014,12/2/2014,33,0,33
10/30/2014,10/30/2014,12/2/2014,33,0,33
11/3/2014,10/30/2014,12/3/2014,34,-4,30
11/5/2014,11/3/2014,12/5/2014,32,-2,30
11/6/2014,11/4/2014,12/8/2014,34,-2,32
11/5/2014,11/5/2014,12/5/2014,30,0,30
1/22/2013,1/22/2013,1/29/2013,7,0,7
1/25/2013,1/25/2013,2/1/2013,7,0,7
1/25/2013,1/25/2013,2/22/2013,28,0,28
1/25/2013,1/25/2013,2/22/2013,28,0,28
1/25/2013,1/25/2013,1/28/2013,3,0,3
2/13/2013,2/11/2013,5/13/2013,91,-2,89
2/14/2013,2/12/2013,5/14/2013,91,-2,89
2/28/2013,2/26/2013,5/31/2013,94,-2,92
2/13/2013,2/13/2013,5/13/2013,89,0,89
2/13/2013,2/13/2013,3/13/2013,28,0,28
2/13/2013,2/13/2013,3/15/2013,30,0,30
2/13/2013,2/13/2013,3/15/2013,30,0,30
2/25/2013,2/25/2013,2/28/2013,3,0,3
2/28/2013,2/26/2013,3/28/2013,30,-2,28
2/28/2013,2/28/2013,3/28/2013,28,0,28
2/28/2013,2/28/2013,3/1/2013,1,0,1
3/4/2013,3/4/2013,3/28/2013,24,0,24
3/6/2013,3/6/2013,3/13/2013,7,0,7
3/6/2013,3/6/2013,3/13/2013,7,0,7
3/8/2013,3/8/2013,6/7/2013,91,0,91
3/8/2013,3/8/2013,3/15/2013,7,0,7
3/8/2013,3/8/2013,4/8/2013,31,0,31
3/14/2013,3/12/2013,4/15/2013,34,-2,32
12/8/2011,12/8/2011,12/9/2011,1,0,1
6/23/2014,6/20/2014,9/23/2014,95,-3,92
6/23/2014,6/23/2014,7/23/2014,30,0,30
6/23/2014,6/23/2014,7/23/2014,30,0,30
6/23/2014,6/23/2014,7/23/2014,30,0,30
6/23/2014,6/23/2014,7/23/2014,30,0,30
6/24/2014,6/24/2014,9/24/2014,92,0,92
6/24/2014,6/24/2014,7/1/2014,7,0,7
6/24/2014,6/24/2014,9/26/2014,94,0,94
6/26/2014,6/26/2014,8/1/2014,36,0,36
6/26/2014,6/26/2014,8/1/2014,36,0,36
6/27/2014,6/26/2014,9/29/2014,95,-1,94
7/1/2014,7/1/2014,7/8/2014,7,0,7
7/2/2014,7/2/2014,7/9/2014,7,0,7
7/2/2014,7/2/2014,10/2/2014,92,0,92
7/2/2014,7/2/2014,8/4/2014,33,0,33
7/2/2014,7/2/2014,8/4/2014,33,0,33
7/7/2014,7/2/2014,8/4/2014,33,-5,28
7/7/2014,7/7/2014,7/14/2014,7,0,7
7/7/2014,7/7/2014,7/14/2014,7,0,7
7/9/2014,7/7/2014,9/9/2014,64,-2,62
7/9/2014,7/7/2014,9/9/2014,64,-2,62
7/10/2014,7/8/2014,8/11/2014,34,-2,32
7/9/2014,7/8/2014,9/30/2014,84,-1,83
7/8/2014,7/8/2014,7/15/2014,7,0,7
7/8/2014,7/8/2014,8/7/2014,30,0,30
7/8/2014,7/8/2014,9/30/2014,84,0,84
7/9/2014,7/9/2014,8/8/2014,30,0,30
7/11/2014,7/10/2014,9/30/2014,82,-1,81
11/16/2012,11/14/2012,2/18/2013,96,-2,94
11/16/2012,11/16/2012,11/26/2012,10,0,10
11/16/2012,11/16/2012,11/26/2012,10,0,10
11/16/2012,11/16/2012,11/19/2012,3,0,3
11/16/2012,11/16/2012,11/19/2012,3,0,3
11/16/2012,11/16/2012,12/14/2012,28,0,28
11/26/2012,11/22/2012,2/26/2013,96,-4,92
11/26/2012,11/22/2012,12/3/2012,11,-4,7
11/26/2012,11/22/2012,12/3/2012,11,-4,7
11/23/2012,11/23/2012,2/25/2013,94,0,94
11/23/2012,11/23/2012,2/25/2013,94,0,94
11/27/2012,11/23/2012,2/27/2013,96,-4,92
11/23/2012,11/23/2012,11/26/2012,3,0,3
11/26/2012,11/26/2012,12/3/2012,7,0,7
11/26/2012,11/26/2012,12/3/2012,7,0,7
11/26/2012,11/26/2012,12/3/2012,7,0,7
11/26/2012,11/26/2012,12/3/2012,7,0,7
11/26/2012,11/26/2012,11/27/2012,1,0,1
11/30/2012,11/30/2012,2/28/2013,90,0,90
11/30/2012,11/30/2012,12/3/2012,3,0,3
11/30/2012,11/30/2012,12/3/2012,3,0,3
11/30/2012,11/30/2012,12/3/2012,3,0,3
11/30/2012,11/30/2012,2/28/2013,90,0,90
12/6/2012,12/6/2012,12/7/2012,1,0,1
12/6/2012,12/6/2012,12/7/2012,1,0,1
12/6/2012,12/6/2012,12/7/2012,1,0,1
12/6/2012,12/6/2012,12/7/2012,1,0,1
5/12/2014,5/7/2014,6/12/2014,36,-5,31
5/12/2014,5/7/2014,6/12/2014,36,-5,31
5/12/2014,5/7/2014,6/12/2014,36,-5,31
5/9/2014,5/9/2014,6/9/2014,31,0,31
5/9/2014,5/9/2014,8/8/2014,91,0,91
5/9/2014,5/9/2014,5/16/2014,7,0,7
5/9/2014,5/9/2014,6/11/2014,33,0,33
5/9/2014,5/9/2014,5/29/2014,20,0,20
5/13/2014,5/13/2014,5/20/2014,7,0,7
5/13/2014,5/13/2014,5/16/2014,3,0,3
5/14/2014,5/14/2014,5/21/2014,7,0,7
5/15/2014,5/15/2014,8/18/2014,95,0,95
5/15/2014,5/15/2014,6/16/2014,32,0,32
5/15/2014,5/15/2014,6/16/2014,32,0,32
5/20/2014,5/15/2014,8/20/2014,97,-5,92
5/16/2014,5/16/2014,6/17/2014,32,0,32
5/16/2014,5/16/2014,5/23/2014,7,0,7
5/16/2014,5/16/2014,8/14/2014,90,0,90
5/21/2014,5/21/2014,6/23/2014,33,0,33
5/21/2014,5/21/2014,5/28/2014,7,0,7
5/21/2014,5/21/2014,5/28/2014,7,0,7
5/21/2014,5/21/2014,5/28/2014,7,0,7
5/22/2014,5/22/2014,6/23/2014,32,0,32
5/22/2014,5/22/2014,8/22/2014,92,0,92
5/23/2014,5/23/2014,8/25/2014,94,0,94
11/5/2014,11/5/2014,12/5/2014,30,0,30
3/13/2013,3/13/2013,3/21/2013,8,0,8
3/15/2013,3/13/2013,4/15/2013,33,-2,31
3/14/2013,3/14/2013,4/15/2013,32,0,32
3/14/2013,3/14/2013,3/21/2013,7,0,7
3/15/2013,3/14/2013,6/13/2013,91,-1,90
3/15/2013,3/15/2013,3/22/2013,7,0,7
3/15/2013,3/15/2013,3/22/2013,7,0,7
3/15/2013,3/15/2013,3/22/2013,7,0,7
3/15/2013,3/15/2013,3/22/2013,7,0,7
4/15/2013,4/15/2013,4/22/2013,7,0,7
4/17/2013,4/17/2013,4/24/2013,7,0,7
4/17/2013,4/17/2013,5/22/2013,35,0,35
4/17/2013,4/17/2013,5/17/2013,30,0,30
4/22/2013,4/18/2013,6/24/2013,67,-4,63
4/22/2013,4/18/2013,5/22/2013,34,-4,30
4/19/2013,4/19/2013,5/22/2013,33,0,33
4/19/2013,4/19/2013,4/22/2013,3,0,3
4/19/2013,4/19/2013,4/29/2013,10,0,10
4/19/2013,4/19/2013,5/21/2013,32,0,32
4/22/2013,4/22/2013,4/29/2013,7,0,7
4/22/2013,4/22/2013,4/29/2013,7,0,7
4/22/2013,4/22/2013,5/2/2013,10,0,10
4/23/2013,4/23/2013,4/30/2013,7,0,7
4/23/2013,4/23/2013,4/30/2013,7,0,7
4/23/2013,4/23/2013,4/30/2013,7,0,7
4/29/2013,4/23/2013,5/24/2013,31,-6,25
4/29/2013,4/24/2013,5/3/2013,9,-5,4
4/24/2013,4/24/2013,5/3/2013,9,0,9
4/29/2013,4/29/2013,5/10/2013,11,0,11
4/29/2013,4/29/2013,5/10/2013,11,0,11
4/30/2013,4/30/2013,5/7/2013,7,0,7
10/23/2012,10/19/2012,10/30/2012,11,-4,7
12/5/2013,12/5/2013,3/6/2014,91,0,91
12/9/2013,12/5/2013,1/9/2014,35,-4,31
7/14/2014,7/14/2014,8/14/2014,31,0,31
7/14/2014,7/14/2014,8/14/2014,31,0,31
7/14/2014,7/14/2014,7/18/2014,4,0,4
7/23/2014,7/21/2014,8/26/2014,36,-2,34
7/21/2014,7/21/2014,7/28/2014,7,0,7
7/23/2014,7/23/2014,8/22/2014,30,0,30
7/23/2014,7/23/2014,7/30/2014,7,0,7
7/24/2014,7/24/2014,7/31/2014,7,0,7
7/25/2014,7/25/2014,8/27/2014,33,0,33
7/28/2014,7/28/2014,8/4/2014,7,0,7
7/31/2014,7/31/2014,8/7/2014,7,0,7
8/11/2014,8/7/2014,9/11/2014,35,-4,31
8/11/2014,8/7/2014,9/11/2014,35,-4,31
8/8/2014,8/8/2014,11/7/2014,91,0,91
8/8/2014,8/8/2014,8/11/2014,3,0,3
8/8/2014,8/8/2014,8/11/2014,3,0,3
8/8/2014,8/8/2014,11/7/2014,91,0,91
8/8/2014,8/8/2014,8/28/2014,20,0,20
8/13/2014,8/11/2014,11/13/2014,94,-2,92
8/18/2014,8/13/2014,9/18/2014,36,-5,31
12/6/2012,12/6/2012,12/7/2012,1,0,1
12/12/2012,12/10/2012,1/14/2013,35,-2,33
12/13/2012,12/13/2012,12/17/2012,4,0,4
12/13/2012,12/13/2012,12/14/2012,1,0,1
12/13/2012,12/13/2012,12/14/2012,1,0,1
12/14/2012,12/14/2012,1/14/2013,31,0,31
12/14/2012,12/14/2012,12/17/2012,3,0,3
12/14/2012,12/14/2012,12/17/2012,3,0,3
12/14/2012,12/14/2012,12/17/2012,3,0,3
12/14/2012,12/14/2012,12/17/2012,3,0,3
12/31/2012,12/31/2012,1/2/2013,2,0,2
12/31/2012,12/31/2012,1/2/2013,2,0,2
12/31/2012,12/31/2012,1/2/2013,2,0,2
12/31/2012,12/31/2012,1/7/2013,7,0,7
1/3/2013,1/3/2013,1/10/2013,7,0,7
1/3/2013,1/3/2013,1/10/2013,7,0,7
1/3/2013,1/3/2013,2/1/2013,29,0,29
1/3/2013,1/3/2013,1/4/2013,1,0,1
1/7/2013,1/7/2013,1/14/2013,7,0,7
1/7/2013,1/7/2013,1/8/2013,1,0,1
1/7/2013,1/7/2013,1/18/2013,11,0,11
1/8/2013,1/8/2013,1/9/2013,1,0,1
1/8/2013,1/8/2013,1/9/2013,1,0,1
1/9/2013,1/9/2013,1/16/2013,7,0,7
1/10/2013,1/9/2013,2/8/2013,30,-1,29
1/10/2013,1/10/2013,1/11/2013,1,0,1
8/28/2014,8/28/2014,9/30/2014,33,0,33
9/12/2014,9/10/2014,12/12/2014,93,-2,91
9/10/2014,9/10/2014,9/17/2014,7,0,7
9/10/2014,9/10/2014,1/5/2015,117,0,117
11/5/2014,11/5/2014,2/5/2015,92,0,92
11/7/2014,11/7/2014,2/9/2015,94,0,94
11/7/2014,11/7/2014,2/6/2015,91,0,91
11/7/2014,11/7/2014,2/6/2015,91,0,91
11/14/2014,11/10/2014,12/15/2014,35,-4,31
11/14/2014,11/12/2014,12/15/2014,33,-2,31
11/24/2014,11/21/2014,12/24/2014,33,-3,30
11/21/2014,11/21/2014,2/19/2015,90,0,90
11/21/2014,11/21/2014,2/19/2015,90,0,90
11/21/2014,11/21/2014,12/22/2014,31,0,31
11/25/2014,11/24/2014,1/7/2015,44,-1,43
11/26/2014,11/26/2014,12/3/2014,7,0,7
11/28/2014,11/27/2014,2/27/2015,92,-1,91
12/1/2014,12/1/2014,3/2/2015,91,0,91
12/2/2014,12/2/2014,12/9/2014,7,0,7
12/2/2014,12/2/2014,12/9/2014,7,0,7
12/4/2014,12/3/2014,1/5/2015,33,-1,32
12/4/2014,12/3/2014,3/5/2015,92,-1,91
4/30/2013,4/30/2013,5/7/2013,7,0,7
4/30/2013,4/30/2013,5/10/2013,10,0,10
4/30/2013,4/30/2013,5/3/2013,3,0,3
5/2/2013,5/2/2013,9/3/2013,124,0,124
5/2/2013,5/2/2013,7/2/2013,61,0,61
5/2/2013,5/2/2013,5/7/2013,5,0,5
5/2/2013,5/2/2013,5/10/2013,8,0,8
5/2/2013,5/2/2013,5/10/2013,8,0,8
5/2/2013,5/2/2013,8/2/2013,92,0,92
6/17/2013,5/3/2013,6/18/2013,46,-45,1
5/13/2013,5/3/2013,8/7/2013,96,-10,86
5/13/2013,5/3/2013,8/7/2013,96,-10,86
5/7/2013,5/3/2013,8/7/2013,96,-4,92
6/17/2013,5/3/2013,6/3/2013,31,-45,-14
5/3/2013,5/3/2013,6/3/2013,31,0,31
5/3/2013,5/3/2013,8/5/2013,94,0,94
5/3/2013,5/3/2013,8/5/2013,94,0,94
5/7/2013,5/7/2013,6/6/2013,30,0,30
5/3/2013,5/3/2013,5/10/2013,7,0,7
5/3/2013,5/3/2013,5/10/2013,7,0,7
6/17/2013,5/3/2013,5/10/2013,7,-45,-38
5/3/2013,5/3/2013,5/10/2013,7,0,7
5/13/2013,5/7/2013,5/13/2013,6,-6,0
5/3/2013,5/3/2013,8/5/2013,94,0,94
5/13/2013,5/7/2013,5/13/2013,6,-6,0
5/13/2013,5/10/2013,6/13/2013,34,-3,31
5/10/2013,5/10/2013,6/13/2013,34,0,34
5/13/2013,5/13/2013,6/13/2013,31,0,31
5/13/2013,5/13/2013,5/21/2013,8,0,8
5/13/2013,5/13/2013,5/21/2013,8,0,8
5/13/2013,5/13/2013,8/13/2013,92,0,92
8/13/2014,8/13/2014,11/13/2014,92,0,92
8/13/2014,8/13/2014,9/12/2014,30,0,30
8/19/2014,8/14/2014,11/19/2014,97,-5,92
8/20/2014,8/18/2014,11/20/2014,94,-2,92
8/18/2014,8/18/2014,8/26/2014,8,0,8
8/18/2014,8/18/2014,8/26/2014,8,0,8
8/19/2014,8/19/2014,11/19/2014,92,0,92
8/19/2014,8/19/2014,11/19/2014,92,0,92
8/19/2014,8/19/2014,8/26/2014,7,0,7
8/26/2014,8/26/2014,9/2/2014,7,0,7
8/26/2014,8/26/2014,9/2/2014,7,0,7
8/26/2014,8/26/2014,12/1/2014,97,0,97
8/28/2014,8/27/2014,11/28/2014,93,-1,92
8/28/2014,8/28/2014,9/30/2014,33,0,33
9/3/2014,9/1/2014,12/3/2014,93,-2,91
9/2/2014,9/2/2014,9/9/2014,7,0,7
9/2/2014,9/2/2014,9/9/2014,7,0,7
9/2/2014,9/2/2014,9/9/2014,7,0,7
9/3/2014,9/3/2014,12/3/2014,91,0,91
9/3/2014,9/3/2014,9/10/2014,7,0,7
9/3/2014,9/3/2014,10/3/2014,30,0,30
9/4/2014,9/4/2014,9/30/2014,26,0,26
9/9/2014,9/5/2014,11/10/2014,66,-4,62
9/5/2014,9/5/2014,12/5/2014,91,0,91
1/11/2013,1/11/2013,1/18/2013,7,0,7
1/11/2013,1/11/2013,1/18/2013,7,0,7
2/5/2013,2/5/2013,2/12/2013,7,0,7
2/5/2013,2/5/2013,2/12/2013,7,0,7
2/5/2013,2/5/2013,2/12/2013,7,0,7
2/6/2013,2/6/2013,5/7/2013,90,0,90
2/8/2013,2/8/2013,2/15/2013,7,0,7
2/8/2013,2/8/2013,3/8/2013,28,0,28
2/8/2013,2/8/2013,3/8/2013,28,0,28
2/19/2013,2/15/2013,5/21/2013,95,-4,91
2/15/2013,2/15/2013,2/22/2013,7,0,7
2/15/2013,2/15/2013,2/22/2013,7,0,7
2/15/2013,2/15/2013,2/22/2013,7,0,7
3/18/2013,3/18/2013,3/25/2013,7,0,7
3/22/2013,3/21/2013,4/22/2013,32,-1,31
3/21/2013,3/21/2013,5/17/2013,57,0,57
3/21/2013,3/21/2013,3/27/2013,6,0,6
3/21/2013,3/21/2013,3/27/2013,6,0,6
3/22/2013,3/22/2013,5/17/2013,56,0,56
3/22/2013,3/22/2013,3/28/2013,6,0,6
3/22/2013,3/22/2013,4/2/2013,11,0,11
3/22/2013,3/22/2013,4/19/2013,28,0,28
4/3/2013,4/3/2013,4/10/2013,7,0,7
4/3/2013,4/3/2013,4/10/2013,7,0,7
12/3/2014,12/3/2014,12/10/2014,7,0,7
12/3/2014,12/3/2014,12/10/2014,7,0,7
12/3/2014,12/3/2014,1/7/2015,35,0,35
12/8/2014,12/4/2014,3/9/2015,95,-4,91
12/8/2014,12/4/2014,3/9/2015,95,-4,91
12/8/2014,12/4/2014,1/8/2015,35,-4,31
12/5/2014,12/5/2014,3/5/2015,90,0,90
12/5/2014,12/5/2014,3/2/2015,87,0,87
12/5/2014,12/5/2014,1/13/2015,39,0,39
12/5/2014,12/5/2014,12/12/2014,7,0,7
12/5/2014,12/5/2014,12/12/2014,7,0,7
12/8/2014,12/8/2014,3/9/2015,91,0,91
12/8/2014,12/8/2014,3/9/2015,91,0,91
12/8/2014,12/8/2014,12/15/2014,7,0,7
12/9/2014,12/9/2014,12/16/2014,7,0,7
12/9/2014,12/9/2014,3/9/2015,90,0,90
12/10/2014,12/10/2014,3/10/2015,90,0,90
12/10/2014,12/10/2014,3/10/2015,90,0,90
12/10/2014,12/10/2014,3/11/2015,91,0,91
12/11/2014,12/11/2014,1/12/2015,32,0,32
12/12/2014,12/12/2014,3/16/2015,94,0,94
12/12/2014,12/12/2014,3/16/2015,94,0,94
12/12/2014,12/12/2014,1/15/2015,34,0,34
12/12/2014,12/12/2014,3/16/2015,94,0,94
12/16/2014,12/16/2014,12/23/2014,7,0,7
12/16/2014,12/16/2014,12/17/2014,1,0,1
12/17/2014,12/17/2014,12/24/2014,7,0,7
12/17/2014,12/17/2014,12/18/2014,1,0,1
12/17/2014,12/17/2014,12/18/2014,1,0,1
5/22/2013,5/21/2013,7/22/2013,62,-1,61
5/21/2013,5/21/2013,6/20/2013,30,0,30
5/21/2013,5/21/2013,5/28/2013,7,0,7
5/24/2013,5/22/2013,6/24/2013,33,-2,31
5/22/2013,5/22/2013,5/29/2013,7,0,7
5/22/2013,5/22/2013,6/18/2013,27,0,27
5/22/2013,5/22/2013,8/21/2013,91,0,91
5/22/2013,5/22/2013,5/29/2013,7,0,7
5/23/2013,5/23/2013,8/21/2013,90,0,90
5/27/2013,5/23/2013,8/28/2013,97,-4,93
5/27/2013,5/24/2013,6/28/2013,35,-3,32
5/27/2013,5/24/2013,6/28/2013,35,-3,32
5/27/2013,5/24/2013,6/28/2013,35,-3,32
5/24/2013,5/24/2013,6/24/2013,31,0,31
5/24/2013,5/24/2013,5/31/2013,7,0,7
5/24/2013,5/24/2013,5/31/2013,7,0,7
5/24/2013,5/24/2013,5/31/2013,7,0,7
5/24/2013,5/24/2013,5/31/2013,7,0,7
5/27/2013,5/24/2013,8/1/2013,69,-3,66
5/29/2013,5/27/2013,8/29/2013,94,-2,92
5/29/2013,5/29/2013,5/31/2013,2,0,2
5/29/2013,5/29/2013,5/31/2013,2,0,2
5/29/2013,5/29/2013,6/5/2013,7,0,7
6/3/2013,5/30/2013,7/3/2013,34,-4,30
5/31/2013,5/31/2013,6/7/2013,7,0,7
6/3/2013,6/3/2013,8/2/2013,60,0,60
6/3/2013,6/3/2013,6/27/2013,24,0,24
6/3/2013,6/3/2013,6/27/2013,24,0,24
6/5/2013,6/5/2013,7/3/2013,28,0,28
9/5/2014,9/5/2014,12/5/2014,91,0,91
9/5/2014,9/5/2014,9/12/2014,7,0,7
9/5/2014,9/5/2014,12/9/2014,95,0,95
9/8/2014,9/8/2014,12/8/2014,91,0,91
9/8/2014,9/8/2014,12/8/2014,91,0,91
9/8/2014,9/8/2014,12/8/2014,91,0,91
9/8/2014,9/8/2014,10/10/2014,32,0,32
9/11/2014,9/9/2014,10/13/2014,34,-2,32
9/11/2014,9/9/2014,10/13/2014,34,-2,32
9/9/2014,9/9/2014,9/16/2014,7,0,7
9/9/2014,9/9/2014,9/16/2014,7,0,7
9/9/2014,9/9/2014,9/16/2014,7,0,7
9/9/2014,9/9/2014,12/10/2014,92,0,92
9/9/2014,9/9/2014,12/9/2014,91,0,91
10/9/2014,9/12/2014,9/15/2014,3,-27,-24
10/9/2014,9/12/2014,9/30/2014,18,-27,-9
10/9/2014,9/12/2014,9/29/2014,17,-27,-10
9/17/2014,9/16/2014,10/20/2014,34,-1,33
9/16/2014,9/16/2014,9/23/2014,7,0,7
10/9/2014,9/16/2014,9/23/2014,7,-23,-16
9/17/2014,9/17/2014,9/24/2014,7,0,7
9/18/2014,9/18/2014,10/22/2014,34,0,34
9/19/2014,9/19/2014,11/24/2014,66,0,66
9/19/2014,9/19/2014,11/24/2014,66,0,66
9/19/2014,9/19/2014,9/26/2014,7,0,7
9/22/2014,9/22/2014,12/23/2014,92,0,92
9/23/2014,9/23/2014,9/26/2014,3,0,3
4/8/2013,4/8/2013,5/13/2013,35,0,35
4/11/2013,4/9/2013,5/13/2013,34,-2,32
4/9/2013,4/9/2013,4/16/2013,7,0,7
4/9/2013,4/9/2013,4/16/2013,7,0,7
4/9/2013,4/9/2013,4/16/2013,7,0,7
4/9/2013,4/9/2013,4/16/2013,7,0,7
4/11/2013,4/11/2013,4/18/2013,7,0,7
5/13/2013,5/7/2013,8/12/2013,97,-6,91
5/10/2013,5/10/2013,6/6/2013,27,0,27
5/10/2013,5/10/2013,6/13/2013,34,0,34
5/10/2013,5/10/2013,6/13/2013,34,0,34
5/10/2013,5/10/2013,5/17/2013,7,0,7
5/10/2013,5/10/2013,5/17/2013,7,0,7
5/13/2013,5/10/2013,6/13/2013,34,-3,31
5/13/2013,5/10/2013,6/7/2013,28,-3,25
6/21/2013,6/21/2013,8/22/2013,62,0,62
7/5/2013,7/5/2013,7/8/2013,3,0,3
7/5/2013,7/5/2013,7/8/2013,3,0,3
7/5/2013,7/5/2013,7/12/2013,7,0,7
7/17/2013,7/17/2013,8/19/2013,33,0,33
7/19/2013,7/19/2013,8/16/2013,28,0,28
7/19/2013,7/19/2013,7/26/2013,7,0,7
7/19/2013,7/19/2013,9/20/2013,63,0,63
7/19/2013,7/19/2013,9/20/2013,63,0,63
7/25/2013,7/25/2013,7/26/2013,1,0,1
7/25/2013,7/25/2013,8/2/2013,8,0,8
7/25/2013,7/25/2013,8/2/2013,8,0,8
8/13/2013,8/13/2013,9/13/2013,31,0,31
8/13/2013,8/13/2013,11/12/2013,91,0,91
11/14/2014,11/14/2014,2/12/2015,90,0,90
11/14/2014,11/14/2014,2/12/2015,90,0,90
11/19/2014,11/17/2014,12/19/2014,32,-2,30
12/22/2014,12/18/2014,1/22/2015,35,-4,31
12/22/2014,12/18/2014,1/22/2015,35,-4,31
12/22/2014,12/18/2014,2/2/2015,46,-4,42
12/22/2014,12/18/2014,2/23/2015,67,-4,63
12/19/2014,12/18/2014,2/2/2015,46,-1,45
12/18/2014,12/18/2014,12/29/2014,11,0,11
12/18/2014,12/18/2014,1/2/2015,15,0,15
12/18/2014,12/18/2014,1/2/2015,15,0,15
12/19/2014,12/19/2014,12/31/2014,12,0,12
12/19/2014,12/19/2014,12/31/2014,12,0,12
12/23/2014,12/23/2014,3/23/2015,90,0,90
12/23/2014,12/23/2014,12/30/2014,7,0,7
12/23/2014,12/23/2014,12/30/2014,7,0,7
12/29/2014,12/24/2014,3/30/2015,96,-5,91
12/30/2014,12/24/2014,3/30/2015,96,-6,90
12/24/2014,12/24/2014,1/28/2015,35,0,35
12/29/2014,12/29/2014,3/30/2015,91,0,91
12/30/2014,12/30/2014,3/30/2015,90,0,90
12/30/2014,12/30/2014,1/6/2015,7,0,7
12/30/2014,12/30/2014,1/6/2015,7,0,7
1/6/2015,1/2/2015,2/5/2015,34,-4,30
1/2/2015,1/2/2015,4/1/2015,89,0,89
1/2/2015,1/2/2015,4/1/2015,89,0,89
1/5/2015,1/5/2015,2/5/2015,31,0,31
1/6/2015,1/5/2015,2/9/2015,35,-1,34
6/5/2013,6/5/2013,6/12/2013,7,0,7
6/6/2013,6/6/2013,6/26/2013,20,0,20
6/26/2013,6/25/2013,8/1/2013,37,-1,36
6/26/2013,6/26/2013,7/3/2013,7,0,7
6/28/2013,6/26/2013,9/27/2013,93,-2,91
6/28/2013,6/26/2013,9/27/2013,93,-2,91
6/28/2013,6/26/2013,8/2/2013,37,-2,35
6/28/2013,6/26/2013,8/1/2013,36,-2,34
6/28/2013,6/27/2013,8/1/2013,35,-1,34
6/27/2013,6/27/2013,8/2/2013,36,0,36
6/27/2013,6/27/2013,8/2/2013,36,0,36
6/27/2013,6/27/2013,8/2/2013,36,0,36
6/27/2013,6/27/2013,8/1/2013,35,0,35
6/28/2013,6/28/2013,7/5/2013,7,0,7
6/28/2013,6/28/2013,7/5/2013,7,0,7
6/28/2013,6/28/2013,7/5/2013,7,0,7
7/15/2013,7/15/2013,8/15/2013,31,0,31
7/15/2013,7/15/2013,7/18/2013,3,0,3
7/16/2013,7/16/2013,8/19/2013,34,0,34
7/17/2013,7/17/2013,8/30/2013,44,0,44
7/17/2013,7/17/2013,8/30/2013,44,0,44
7/19/2013,7/18/2013,9/20/2013,64,-1,63
7/18/2013,7/18/2013,8/19/2013,32,0,32
7/29/2013,7/29/2013,8/2/2013,4,0,4
7/29/2013,7/29/2013,8/2/2013,4,0,4
7/31/2013,7/30/2013,9/2/2013,34,-1,33
7/30/2013,7/30/2013,9/30/2013,62,0,62
7/31/2013,7/30/2013,9/30/2013,62,-1,61
7/30/2013,7/30/2013,9/5/2013,37,0,37
7/30/2013,7/30/2013,9/5/2013,37,0,37
8/1/2013,7/31/2013,11/4/2013,96,-1,95
9/24/2014,9/24/2014,12/23/2014,90,0,90
9/24/2014,9/24/2014,9/26/2014,2,0,2
9/25/2014,9/24/2014,12/29/2014,96,-1,95
9/25/2014,9/24/2014,10/27/2014,33,-1,32
9/25/2014,9/25/2014,11/5/2014,41,0,41
9/30/2014,9/25/2014,11/3/2014,39,-5,34
9/30/2014,9/26/2014,11/3/2014,38,-4,34
9/26/2014,9/26/2014,10/3/2014,7,0,7
9/26/2014,9/26/2014,10/31/2014,35,0,35
10/2/2014,10/2/2014,12/3/2014,62,0,62
10/2/2014,10/2/2014,12/3/2014,62,0,62
10/2/2014,10/2/2014,1/6/2015,96,0,96
10/3/2014,10/3/2014,10/10/2014,7,0,7
10/3/2014,10/3/2014,10/10/2014,7,0,7
10/3/2014,10/3/2014,10/10/2014,7,0,7
10/3/2014,10/3/2014,11/5/2014,33,0,33
10/7/2014,10/7/2014,11/12/2014,36,0,36
10/10/2014,10/8/2014,11/13/2014,36,-2,34
10/10/2014,10/9/2014,11/13/2014,35,-1,34
10/10/2014,10/9/2014,11/5/2014,27,-1,26
10/10/2014,10/10/2014,10/17/2014,7,0,7
10/10/2014,10/10/2014,10/17/2014,7,0,7
10/10/2014,10/10/2014,11/12/2014,33,0,33
10/10/2014,10/10/2014,11/12/2014,33,0,33
10/10/2014,10/10/2014,11/14/2014,35,0,35
10/20/2014,10/16/2014,11/20/2014,35,-4,31
10/20/2014,10/20/2014,11/14/2014,25,0,25
10/23/2014,10/23/2014,11/26/2014,34,0,34
10/27/2014,10/27/2014,11/25/2014,29,0,29
10/31/2014,10/31/2014,11/7/2014,7,0,7
9/11/2013,9/11/2013,12/12/2013,92,0,92
10/25/2013,10/25/2013,10/25/2013,0,0,0
10/31/2013,10/31/2013,12/2/2013,32,0,32
10/31/2013,10/31/2013,11/7/2013,7,0,7
11/4/2013,11/4/2013,11/8/2013,4,0,4
11/6/2013,11/5/2013,12/9/2013,34,-1,33
11/7/2013,11/5/2013,2/7/2014,94,-2,92
11/7/2013,11/6/2013,6/30/2014,236,-1,235
11/7/2013,11/6/2013,2/7/2014,93,-1,92
11/7/2013,11/7/2013,2/5/2014,90,0,90
11/7/2013,11/7/2013,11/14/2013,7,0,7
11/7/2013,11/7/2013,2/7/2014,92,0,92
11/8/2013,11/8/2013,11/12/2013,4,0,4
11/12/2013,11/12/2013,2/12/2014,92,0,92
11/12/2013,11/12/2013,11/19/2013,7,0,7
11/12/2013,11/12/2013,2/10/2014,90,0,90
11/13/2013,11/13/2013,11/20/2013,7,0,7
11/13/2013,11/13/2013,11/20/2013,7,0,7
12/10/2013,12/10/2013,3/11/2014,91,0,91
12/30/2013,12/30/2013,1/6/2014,7,0,7
12/30/2013,12/30/2013,1/6/2014,7,0,7
12/30/2013,12/30/2013,2/3/2014,35,0,35
12/12/2011,12/12/2011,12/19/2011,7,0,7
12/12/2011,12/12/2011,12/19/2011,7,0,7
4/16/2012,4/16/2012,5/18/2012,32,0,32
4/16/2012,4/16/2012,4/17/2012,1,0,1
4/17/2012,4/17/2012,5/18/2012,31,0,31
4/17/2012,4/17/2012,5/2/2012,15,0,15
4/17/2012,4/17/2012,4/24/2012,7,0,7
4/17/2012,4/17/2012,4/24/2012,7,0,7
4/17/2012,4/17/2012,4/18/2012,1,0,1
4/17/2012,4/17/2012,4/18/2012,1,0,1
4/17/2012,4/17/2012,4/18/2012,1,0,1
4/17/2012,4/17/2012,4/18/2012,1,0,1
4/18/2012,4/18/2012,4/25/2012,7,0,7
4/19/2012,4/19/2012,4/26/2012,7,0,7
4/19/2012,4/19/2012,4/26/2012,7,0,7
4/19/2012,4/19/2012,4/20/2012,1,0,1
4/19/2012,4/19/2012,4/20/2012,1,0,1
4/23/2012,4/19/2012,5/23/2012,34,-4,30
4/20/2012,4/20/2012,4/23/2012,3,0,3
4/20/2012,4/20/2012,4/27/2012,7,0,7
11/6/2012,11/5/2012,2/6/2013,93,-1,92
11/6/2012,11/5/2012,11/13/2012,8,-1,7
11/7/2012,11/6/2012,2/7/2013,93,-1,92
11/6/2012,11/6/2012,11/7/2012,1,0,1
11/6/2012,11/6/2012,11/7/2012,1,0,1
11/7/2012,11/7/2012,11/14/2012,7,0,7
11/7/2012,11/7/2012,11/8/2012,1,0,1
11/8/2012,11/8/2012,11/15/2012,7,0,7
8/1/2013,8/1/2013,11/4/2013,95,0,95
8/1/2013,8/1/2013,8/9/2013,8,0,8
8/1/2013,8/1/2013,9/27/2013,57,0,57
8/2/2013,8/2/2013,11/7/2013,97,0,97
8/6/2013,8/5/2013,11/7/2013,94,-1,93
8/6/2013,8/5/2013,11/7/2013,94,-1,93
8/6/2013,8/5/2013,11/7/2013,94,-1,93
8/27/2013,8/27/2013,8/30/2013,3,0,3
8/27/2013,8/27/2013,9/3/2013,7,0,7
8/27/2013,8/27/2013,9/3/2013,7,0,7
8/29/2013,8/29/2013,12/2/2013,95,0,95
9/2/2013,8/29/2013,12/2/2013,95,-4,91
8/30/2013,8/30/2013,9/27/2013,28,0,28
8/30/2013,8/30/2013,9/6/2013,7,0,7
9/10/2013,9/10/2013,9/17/2013,7,0,7
9/10/2013,9/10/2013,9/17/2013,7,0,7
9/11/2013,9/11/2013,12/10/2013,90,0,90
9/16/2013,9/12/2013,10/16/2013,34,-4,30
9/16/2013,9/16/2013,10/16/2013,30,0,30
9/16/2013,9/16/2013,9/23/2013,7,0,7
9/17/2013,9/17/2013,10/11/2013,24,0,24
9/17/2013,9/17/2013,10/11/2013,24,0,24
9/20/2013,9/20/2013,9/27/2013,7,0,7
11/3/2014,11/3/2014,11/4/2014,1,0,1
11/3/2014,11/3/2014,12/8/2014,35,0,35
11/7/2014,11/6/2014,1/12/2015,67,-1,66
11/12/2014,11/12/2014,11/19/2014,7,0,7
11/12/2014,11/12/2014,2/12/2015,92,0,92
11/12/2014,11/12/2014,12/22/2014,40,0,40
11/14/2014,11/14/2014,12/12/2014,28,0,28
11/14/2014,11/14/2014,2/12/2015,90,0,90
11/20/2014,11/18/2014,12/22/2014,34,-2,32
11/19/2014,11/18/2014,2/19/2015,93,-1,92
11/21/2014,11/19/2014,12/22/2014,33,-2,31
11/21/2014,11/19/2014,2/23/2015,96,-2,94
11/19/2014,11/19/2014,2/19/2015,92,0,92
11/19/2014,11/19/2014,11/21/2014,2,0,2
11/19/2014,11/19/2014,11/26/2014,7,0,7
11/24/2014,11/20/2014,1/26/2015,67,-4,63
11/26/2014,11/25/2014,2/27/2015,94,-1,93
11/25/2014,11/25/2014,2/25/2015,92,0,92
11/28/2014,11/26/2014,12/30/2014,34,-2,32
11/26/2014,11/26/2014,12/22/2014,26,0,26
12/3/2014,12/3/2014,3/3/2015,90,0,90
11/28/2014,11/28/2014,12/5/2014,7,0,7
12/1/2014,12/1/2014,2/27/2015,88,0,88
11/8/2012,11/8/2012,11/15/2012,7,0,7
11/8/2012,11/8/2012,11/9/2012,1,0,1
11/8/2012,11/8/2012,11/9/2012,1,0,1
11/8/2012,11/8/2012,11/9/2012,1,0,1
12/28/2012,12/28/2012,2/1/2013,35,0,35
12/28/2012,12/28/2012,2/1/2013,35,0,35
12/28/2012,12/28/2012,1/7/2013,10,0,10
12/28/2012,12/28/2012,1/4/2013,7,0,7
12/28/2012,12/28/2012,12/31/2012,3,0,3
12/28/2012,12/28/2012,12/31/2012,3,0,3
12/28/2012,12/28/2012,12/31/2012,3,0,3
2/19/2013,2/19/2013,5/21/2013,91,0,91
2/22/2013,2/20/2013,4/22/2013,61,-2,59
12/10/2014,12/8/2014,3/10/2015,92,-2,90
12/10/2014,12/8/2014,3/10/2015,92,-2,90
12/11/2014,12/11/2014,3/11/2015,90,0,90
12/11/2014,12/11/2014,3/11/2015,90,0,90
12/19/2014,12/17/2014,3/19/2015,92,-2,90
12/19/2014,12/17/2014,2/2/2015,47,-2,45
12/22/2014,12/19/2014,3/23/2015,94,-3,91
12/22/2014,12/19/2014,2/27/2015,70,-3,67
12/22/2014,12/22/2014,2/2/2015,42,0,42
12/22/2014,12/22/2014,12/23/2014,1,0,1
12/23/2014,12/23/2014,3/23/2015,90,0,90
12/29/2014,12/29/2014,12/30/2014,1,0,1
12/30/2014,12/30/2014,1/6/2015,7,0,7
12/30/2014,12/30/2014,1/6/2015,7,0,7
9/30/2013,9/30/2013,12/2/2013,63,0,63
9/30/2013,9/30/2013,11/1/2013,32,0,32
9/30/2013,9/30/2013,10/7/2013,7,0,7
9/30/2013,9/30/2013,10/7/2013,7,0,7
10/7/2013,10/3/2013,11/7/2013,35,-4,31
10/4/2013,10/4/2013,10/11/2013,7,0,7
10/4/2013,10/4/2013,10/11/2013,7,0,7
10/16/2013,10/16/2013,11/15/2013,30,0,30
10/16/2013,10/16/2013,12/20/2013,65,0,65
10/16/2013,10/16/2013,10/23/2013,7,0,7
10/17/2013,10/17/2013,11/18/2013,32,0,32
10/21/2013,10/18/2013,1/22/2014,96,-3,93
10/31/2013,10/31/2013,12/2/2013,32,0,32
10/31/2013,10/31/2013,12/2/2013,32,0,32
10/31/2013,10/31/2013,12/2/2013,32,0,32
10/31/2013,10/31/2013,2/3/2014,95,0,95
11/19/2013,11/19/2013,11/26/2013,7,0,7
11/21/2013,11/21/2013,2/21/2014,92,0,92
11/22/2013,11/22/2013,12/2/2013,10,0,10
11/22/2013,11/22/2013,12/2/2013,10,0,10
12/6/2013,12/6/2013,3/6/2014,90,0,90
12/6/2013,12/6/2013,12/13/2013,7,0,7
12/6/2013,12/6/2013,12/13/2013,7,0,7
2/28/2012,2/28/2012,2/29/2012,1,0,1
2/29/2012,2/29/2012,3/1/2012,1,0,1
2/29/2012,2/29/2012,3/1/2012,1,0,1
3/1/2012,3/1/2012,3/8/2012,7,0,7
3/1/2012,3/1/2012,3/8/2012,7,0,7
3/1/2012,3/1/2012,3/29/2012,28,0,28
3/1/2012,3/1/2012,3/29/2012,28,0,28
3/1/2012,3/1/2012,3/2/2012,1,0,1
3/1/2012,3/1/2012,3/2/2012,1,0,1
3/5/2012,3/1/2012,3/12/2012,11,-4,7
4/4/2012,4/2/2012,4/11/2012,9,-2,7
4/4/2012,4/2/2012,4/5/2012,3,-2,1
4/4/2012,4/4/2012,4/11/2012,7,0,7
4/4/2012,4/4/2012,4/5/2012,1,0,1
4/10/2012,4/4/2012,4/17/2012,13,-6,7
4/10/2012,4/4/2012,4/17/2012,13,-6,7
4/4/2012,4/4/2012,4/5/2012,1,0,1
4/5/2012,4/5/2012,4/12/2012,7,0,7
4/5/2012,4/5/2012,4/12/2012,7,0,7
4/5/2012,4/5/2012,4/12/2012,7,0,7
4/5/2012,4/5/2012,4/10/2012,5,0,5
8/9/2012,7/24/2012,11/23/2012,122,-16,106
7/25/2012,7/24/2012,8/2/2012,9,-1,8
7/26/2012,7/26/2012,7/27/2012,1,0,1
8/2/2012,8/2/2012,8/9/2012,7,0,7
7/27/2012,7/26/2012,8/3/2012,8,-1,7
7/27/2012,7/26/2012,7/30/2012,4,-1,3
7/27/2012,7/26/2012,7/30/2012,4,-1,3
7/27/2012,7/26/2012,7/30/2012,4,-1,3
7/31/2012,7/27/2012,9/28/2012,63,-4,59
8/2/2012,8/2/2012,8/9/2012,7,0,7
8/2/2012,8/2/2012,8/9/2012,7,0,7
8/2/2012,8/2/2012,8/9/2012,7,0,7
8/2/2012,8/2/2012,8/3/2012,1,0,1
12/28/2011,12/28/2011,12/29/2011,1,0,1
12/28/2011,12/28/2011,12/29/2011,1,0,1
12/28/2011,12/28/2011,12/29/2011,1,0,1
12/28/2011,12/28/2011,12/29/2011,1,0,1
1/6/2012,1/6/2012,1/11/2012,5,0,5
1/6/2012,1/6/2012,1/9/2012,3,0,3
1/6/2012,1/6/2012,1/9/2012,3,0,3
1/23/2012,1/23/2012,1/24/2012,1,0,1
1/23/2012,1/23/2012,1/24/2012,1,0,1
1/23/2012,1/23/2012,1/24/2012,1,0,1
1/26/2012,1/24/2012,2/2/2012,9,-2,7
1/26/2012,1/24/2012,2/27/2012,34,-2,32
1/24/2012,1/24/2012,1/25/2012,1,0,1
1/24/2012,1/24/2012,1/25/2012,1,0,1
1/26/2012,1/26/2012,1/27/2012,1,0,1
1/26/2012,1/26/2012,1/27/2012,1,0,1
1/30/2012,1/26/2012,2/29/2012,34,-4,30
1/30/2012,1/27/2012,2/6/2012,10,-3,7
1/27/2012,1/27/2012,2/6/2012,10,0,10
1/27/2012,1/27/2012,2/3/2012,7,0,7
1/27/2012,1/27/2012,2/3/2012,7,0,7
1/27/2012,1/27/2012,2/3/2012,7,0,7
1/27/2012,1/27/2012,1/30/2012,3,0,3
1/27/2012,1/27/2012,1/30/2012,3,0,3
1/27/2012,1/27/2012,1/30/2012,3,0,3
2/1/2012,2/1/2012,2/2/2012,1,0,1
2/1/2012,2/1/2012,2/2/2012,1,0,1
2/1/2012,2/1/2012,2/2/2012,1,0,1
2/2/2012,2/2/2012,2/3/2012,1,0,1
2/2/2012,2/2/2012,2/3/2012,1,0,1
2/13/2012,2/13/2012,2/14/2012,1,0,1
2/14/2012,2/14/2012,2/15/2012,1,0,1
2/16/2012,2/14/2012,2/23/2012,9,-2,7
2/17/2012,2/17/2012,2/24/2012,7,0,7
2/17/2012,2/17/2012,2/24/2012,7,0,7
2/17/2012,2/17/2012,2/21/2012,4,0,4
12/11/2013,12/11/2013,12/18/2013,7,0,7
12/13/2013,12/13/2013,12/19/2013,6,0,6
12/13/2013,12/13/2013,12/20/2013,7,0,7
12/18/2013,12/16/2013,2/18/2014,64,-2,62
12/16/2013,12/16/2013,1/16/2014,31,0,31
12/16/2013,12/16/2013,1/16/2014,31,0,31
12/16/2013,12/16/2013,12/17/2013,1,0,1
12/18/2013,12/18/2013,12/19/2013,1,0,1
12/18/2013,12/18/2013,12/24/2013,6,0,6
12/18/2013,12/18/2013,12/24/2013,6,0,6
12/18/2013,12/18/2013,12/24/2013,6,0,6
12/18/2013,12/18/2013,12/27/2013,9,0,9
12/18/2013,12/18/2013,3/19/2014,91,0,91
12/23/2013,12/19/2013,3/24/2014,95,-4,91
12/23/2013,12/19/2013,1/23/2014,35,-4,31
12/20/2013,12/19/2013,3/20/2014,91,-1,90
12/19/2013,12/19/2013,12/24/2013,5,0,5
12/24/2013,12/24/2013,12/31/2013,7,0,7
12/24/2013,12/24/2013,12/30/2013,6,0,6
12/24/2013,12/24/2013,12/30/2013,6,0,6
12/24/2013,12/24/2013,12/27/2013,3,0,3
12/12/2011,12/12/2011,12/16/2011,4,0,4
12/13/2011,12/13/2011,12/16/2011,3,0,3
2/7/2012,2/7/2012,2/10/2012,3,0,3
2/9/2012,2/9/2012,2/10/2012,1,0,1
2/9/2012,2/9/2012,2/10/2012,1,0,1
2/13/2012,2/9/2012,2/20/2012,11,-4,7
2/10/2012,2/10/2012,3/8/2012,27,0,27
2/10/2012,2/10/2012,2/13/2012,3,0,3
2/10/2012,2/10/2012,2/13/2012,3,0,3
2/10/2012,2/10/2012,2/17/2012,7,0,7
3/26/2012,3/26/2012,3/27/2012,1,0,1
3/26/2012,3/26/2012,3/27/2012,1,0,1
3/28/2012,3/26/2012,4/4/2012,9,-2,7
3/28/2012,3/26/2012,4/4/2012,9,-2,7
3/27/2012,3/26/2012,3/28/2012,2,-1,1
3/27/2012,3/26/2012,3/28/2012,2,-1,1
3/26/2012,3/26/2012,4/3/2012,8,0,8
3/30/2012,3/29/2012,5/3/2012,35,-1,34
3/30/2012,3/29/2012,4/5/2012,7,-1,6
3/30/2012,3/29/2012,4/10/2012,12,-1,11
3/29/2012,3/29/2012,4/2/2012,4,0,4
4/2/2012,4/2/2012,4/3/2012,1,0,1
4/3/2012,4/3/2012,4/4/2012,1,0,1
4/10/2012,4/10/2012,5/10/2012,30,0,30
4/10/2012,4/10/2012,4/17/2012,7,0,7
4/10/2012,4/10/2012,4/11/2012,1,0,1
4/11/2012,4/11/2012,4/18/2012,7,0,7
4/11/2012,4/11/2012,4/12/2012,1,0,1
4/11/2012,4/11/2012,4/12/2012,1,0,1
4/11/2012,4/11/2012,4/12/2012,1,0,1
4/12/2012,4/12/2012,4/19/2012,7,0,7
4/12/2012,4/12/2012,4/19/2012,7,0,7
4/12/2012,4/12/2012,4/19/2012,7,0,7
4/12/2012,4/12/2012,4/19/2012,7,0,7
4/12/2012,4/12/2012,4/13/2012,1,0,1
4/12/2012,4/12/2012,4/13/2012,1,0,1
4/12/2012,4/12/2012,4/13/2012,1,0,1
1/3/2014,12/31/2013,3/3/2014,62,-3,59
12/31/2013,12/31/2013,1/7/2014,7,0,7
1/6/2014,1/3/2014,2/6/2014,34,-3,31
1/7/2014,1/6/2014,1/15/2014,9,-1,8
1/9/2014,1/7/2014,2/10/2014,34,-2,32
1/9/2014,1/7/2014,2/10/2014,34,-2,32
1/7/2014,1/7/2014,1/14/2014,7,0,7
1/7/2014,1/7/2014,1/14/2014,7,0,7
1/6/2012,1/6/2012,1/9/2012,3,0,3
1/6/2012,1/6/2012,1/9/2012,3,0,3
1/6/2012,1/6/2012,1/9/2012,3,0,3
1/6/2012,1/6/2012,1/9/2012,3,0,3
2/20/2012,2/20/2012,2/21/2012,1,0,1
2/22/2012,2/20/2012,2/29/2012,9,-2,7
2/21/2012,2/21/2012,2/22/2012,1,0,1
2/21/2012,2/21/2012,2/28/2012,7,0,7
2/23/2012,2/21/2012,3/23/2012,31,-2,29
2/22/2012,2/22/2012,2/23/2012,1,0,1
2/22/2012,2/22/2012,2/23/2012,1,0,1
2/22/2012,2/22/2012,2/29/2012,7,0,7
2/24/2012,2/24/2012,3/23/2012,28,0,28
2/24/2012,2/24/2012,2/27/2012,3,0,3
3/19/2012,3/19/2012,3/20/2012,1,0,1
2/24/2012,2/24/2012,3/2/2012,7,0,7
3/20/2012,3/20/2012,3/21/2012,1,0,1
3/20/2012,3/20/2012,3/21/2012,1,0,1
3/20/2012,3/20/2012,3/21/2012,1,0,1
3/21/2012,3/21/2012,3/22/2012,1,0,1
3/26/2012,3/23/2012,6/27/2012,96,-3,93
3/23/2012,3/23/2012,3/30/2012,7,0,7
3/23/2012,3/23/2012,3/30/2012,7,0,7
3/23/2012,3/23/2012,3/26/2012,3,0,3
5/2/2012,5/2/2012,5/9/2012,7,0,7
5/2/2012,5/2/2012,5/9/2012,7,0,7
5/2/2012,5/2/2012,5/3/2012,1,0,1
5/2/2012,5/2/2012,5/3/2012,1,0,1
5/3/2012,5/3/2012,6/6/2012,34,0,34
5/3/2012,5/3/2012,6/6/2012,34,0,34
1/10/2014,1/10/2014,1/17/2014,7,0,7
1/10/2014,1/10/2014,1/17/2014,7,0,7
1/10/2014,1/10/2014,1/17/2014,7,0,7
1/13/2014,1/10/2014,4/16/2014,96,-3,93
1/21/2014,1/21/2014,1/28/2014,7,0,7
1/22/2014,1/21/2014,2/24/2014,34,-1,33
1/31/2014,1/29/2014,3/3/2014,33,-2,31
1/29/2014,1/29/2014,2/6/2014,8,0,8
2/11/2014,2/10/2014,5/13/2014,92,-1,91
2/12/2014,2/11/2014,8/11/2014,181,-1,180
2/11/2014,2/11/2014,2/18/2014,7,0,7
2/11/2014,2/11/2014,2/18/2014,7,0,7
2/11/2014,2/11/2014,5/13/2014,91,0,91
2/19/2014,2/18/2014,5/20/2014,91,-1,90
2/18/2014,2/18/2014,3/18/2014,28,0,28
2/18/2014,2/18/2014,2/25/2014,7,0,7
2/19/2014,2/19/2014,3/21/2014,30,0,30
2/19/2014,2/19/2014,2/27/2014,8,0,8
2/21/2014,2/20/2014,3/24/2014,32,-1,31
2/24/2014,2/21/2014,5/22/2014,90,-3,87
2/28/2014,2/28/2014,3/7/2014,7,0,7
5/5/2014,2/28/2014,3/7/2014,7,-66,-59
3/3/2014,3/3/2014,3/10/2014,7,0,7
3/4/2014,3/4/2014,6/5/2014,93,0,93
3/4/2014,3/4/2014,3/5/2014,1,0,1
3/10/2014,3/6/2014,4/10/2014,35,-4,31
3/5/2012,3/5/2012,3/29/2012,24,0,24
3/5/2012,3/5/2012,3/6/2012,1,0,1
3/7/2012,3/5/2012,3/14/2012,9,-2,7
3/7/2012,3/7/2012,3/8/2012,1,0,1
3/8/2012,3/8/2012,3/15/2012,7,0,7
3/8/2012,3/8/2012,3/15/2012,7,0,7
3/8/2012,3/8/2012,3/13/2012,5,0,5
3/8/2012,3/8/2012,3/15/2012,7,0,7
3/21/2012,3/21/2012,3/26/2012,5,0,5
3/9/2012,3/9/2012,3/16/2012,7,0,7
3/9/2012,3/9/2012,3/12/2012,3,0,3
3/22/2012,3/22/2012,3/27/2012,5,0,5
4/18/2012,4/18/2012,4/19/2012,1,0,1
4/18/2012,4/18/2012,4/19/2012,1,0,1
4/24/2012,4/24/2012,4/24/2012,0,0,0
5/7/2012,5/7/2012,5/9/2012,2,0,2
5/8/2012,5/8/2012,6/6/2012,29,0,29
5/8/2012,5/8/2012,5/9/2012,1,0,1
5/9/2012,5/9/2012,5/10/2012,1,0,1
5/9/2012,5/9/2012,5/10/2012,1,0,1
5/22/2012,5/22/2012,5/23/2012,1,0,1
5/23/2012,5/23/2012,5/24/2012,1,0,1
5/23/2012,5/23/2012,5/24/2012,1,0,1
5/23/2012,5/23/2012,6/20/2012,28,0,28
5/24/2012,5/24/2012,5/25/2012,1,0,1
5/24/2012,5/24/2012,5/25/2012,1,0,1
5/25/2012,5/25/2012,5/31/2012,6,0,6
5/25/2012,5/25/2012,5/29/2012,4,0,4
5/25/2012,5/25/2012,5/29/2012,4,0,4
6/6/2012,6/4/2012,6/13/2012,9,-2,7
6/4/2012,6/4/2012,6/5/2012,1,0,1
6/4/2012,6/4/2012,6/11/2012,7,0,7
6/4/2012,6/4/2012,6/5/2012,1,0,1
6/5/2012,6/5/2012,6/6/2012,1,0,1
6/7/2012,6/7/2012,6/14/2012,7,0,7
2/3/2014,2/3/2014,6/3/2014,120,0,120
2/3/2014,2/3/2014,3/10/2014,35,0,35
2/3/2014,2/3/2014,3/10/2014,35,0,35
2/7/2014,2/5/2014,3/7/2014,30,-2,28
2/7/2014,2/5/2014,3/7/2014,30,-2,28
2/10/2014,2/10/2014,5/12/2014,91,0,91
2/11/2014,2/10/2014,5/12/2014,91,-1,90
2/20/2014,2/19/2014,5/21/2014,91,-1,90
2/20/2014,2/19/2014,5/21/2014,91,-1,90
2/20/2014,2/19/2014,3/21/2014,30,-1,29
2/25/2014,2/25/2014,2/28/2014,3,0,3
2/27/2014,2/27/2014,5/27/2014,89,0,89
3/3/2014,2/27/2014,4/3/2014,35,-4,31
3/3/2014,2/27/2014,4/3/2014,35,-4,31
2/28/2014,2/27/2014,5/30/2014,92,-1,91
3/7/2014,3/5/2014,5/7/2014,63,-2,61
3/5/2014,3/5/2014,6/5/2014,92,0,92
3/5/2014,3/5/2014,3/31/2014,26,0,26
3/5/2014,3/5/2014,3/31/2014,26,0,26
3/6/2014,3/6/2014,6/6/2014,92,0,92
3/6/2014,3/6/2014,6/6/2014,92,0,92
3/6/2014,3/6/2014,3/13/2014,7,0,7
3/6/2014,3/6/2014,3/10/2014,4,0,4
3/7/2014,3/7/2014,3/14/2014,7,0,7
1/30/2012,1/30/2012,1/31/2012,1,0,1
1/30/2012,1/30/2012,1/31/2012,1,0,1
1/30/2012,1/30/2012,2/3/2012,4,0,4
1/30/2012,1/30/2012,2/28/2012,29,0,29
1/30/2012,1/30/2012,1/31/2012,1,0,1
1/30/2012,1/30/2012,1/31/2012,1,0,1
2/2/2012,1/31/2012,2/9/2012,9,-2,7
1/31/2012,1/31/2012,2/1/2012,1,0,1
1/31/2012,1/31/2012,2/1/2012,1,0,1
1/31/2012,1/31/2012,2/1/2012,1,0,1
2/3/2012,2/3/2012,2/6/2012,3,0,3
2/7/2012,2/3/2012,5/7/2012,94,-4,90
2/3/2012,2/3/2012,2/6/2012,3,0,3
2/7/2012,2/7/2012,5/7/2012,90,0,90
2/7/2012,2/7/2012,2/14/2012,7,0,7
2/7/2012,2/7/2012,2/8/2012,1,0,1
2/7/2012,2/7/2012,2/8/2012,1,0,1
2/7/2012,2/7/2012,2/14/2012,7,0,7
2/7/2012,2/7/2012,2/14/2012,7,0,7
2/8/2012,2/8/2012,2/14/2012,6,0,6
2/8/2012,2/8/2012,2/9/2012,1,0,1
2/8/2012,2/8/2012,2/15/2012,7,0,7
2/8/2012,2/8/2012,2/15/2012,7,0,7
2/10/2012,2/8/2012,2/17/2012,9,-2,7
2/9/2012,2/9/2012,2/16/2012,7,0,7
2/9/2012,2/9/2012,2/16/2012,7,0,7
2/9/2012,2/9/2012,2/10/2012,1,0,1
2/14/2012,2/10/2012,2/21/2012,11,-4,7
2/14/2012,2/10/2012,5/14/2012,94,-4,90
4/23/2012,4/23/2012,4/24/2012,1,0,1
4/25/2012,4/25/2012,5/2/2012,7,0,7
4/25/2012,4/25/2012,4/26/2012,1,0,1
4/25/2012,4/25/2012,4/26/2012,1,0,1
4/27/2012,4/27/2012,5/4/2012,7,0,7
4/30/2012,4/27/2012,5/9/2012,12,-3,9
4/30/2012,4/27/2012,5/9/2012,12,-3,9
1/14/2014,1/13/2014,2/17/2014,35,-1,34
1/14/2014,1/13/2014,2/17/2014,35,-1,34
1/14/2014,1/14/2014,1/21/2014,7,0,7
1/14/2014,1/14/2014,1/21/2014,7,0,7
1/14/2014,1/14/2014,1/21/2014,7,0,7
1/17/2014,1/17/2014,1/24/2014,7,0,7
1/17/2014,1/17/2014,1/24/2014,7,0,7
3/10/2014,3/6/2014,4/10/2014,35,-4,31
3/10/2014,3/6/2014,5/12/2014,67,-4,63
3/11/2014,3/11/2014,5/9/2014,59,0,59
3/11/2014,3/11/2014,3/31/2014,20,0,20
3/11/2014,3/11/2014,5/5/2014,55,0,55
3/12/2014,3/12/2014,3/31/2014,19,0,19
3/12/2014,3/12/2014,3/31/2014,19,0,19
3/12/2014,3/12/2014,4/14/2014,33,0,33
3/12/2014,3/12/2014,3/21/2014,9,0,9
3/12/2014,3/12/2014,3/21/2014,9,0,9
3/13/2014,3/13/2014,3/20/2014,7,0,7
3/13/2014,3/13/2014,3/20/2014,7,0,7
3/17/2014,3/13/2014,4/17/2014,35,-4,31
3/18/2014,3/14/2014,5/19/2014,66,-4,62
3/14/2014,3/14/2014,3/21/2014,7,0,7
3/14/2014,3/14/2014,3/21/2014,7,0,7
3/14/2014,3/14/2014,3/21/2014,7,0,7
3/17/2014,3/17/2014,5/16/2014,60,0,60
3/17/2014,3/17/2014,3/24/2014,7,0,7
3/17/2014,3/17/2014,3/24/2014,7,0,7
3/18/2014,3/18/2014,5/19/2014,62,0,62
3/18/2014,3/18/2014,3/19/2014,1,0,1
3/18/2014,3/18/2014,3/25/2014,7,0,7
3/19/2014,3/19/2014,3/26/2014,7,0,7
3/19/2014,3/19/2014,5/19/2014,61,0,61
2/13/2012,2/13/2012,2/14/2012,1,0,1
2/13/2012,2/13/2012,2/14/2012,1,0,1
2/15/2012,2/14/2012,2/22/2012,8,-1,7
2/14/2012,2/14/2012,2/15/2012,1,0,1
2/14/2012,2/14/2012,2/15/2012,1,0,1
2/14/2012,2/14/2012,2/27/2012,13,0,13
2/20/2012,2/16/2012,2/27/2012,11,-4,7
2/17/2012,2/17/2012,2/24/2012,7,0,7
3/12/2012,3/12/2012,3/13/2012,1,0,1
3/12/2012,3/12/2012,4/10/2012,29,0,29
3/13/2012,3/13/2012,3/14/2012,1,0,1
3/13/2012,3/13/2012,3/14/2012,1,0,1
3/13/2012,3/13/2012,3/14/2012,1,0,1
3/15/2012,3/15/2012,3/22/2012,7,0,7
3/15/2012,3/15/2012,3/22/2012,7,0,7
3/16/2012,3/15/2012,3/23/2012,8,-1,7
3/15/2012,3/15/2012,3/16/2012,1,0,1
3/16/2012,3/16/2012,4/16/2012,31,0,31
3/16/2012,3/16/2012,3/19/2012,3,0,3
3/16/2012,3/16/2012,3/23/2012,7,0,7
3/16/2012,3/16/2012,3/23/2012,7,0,7
6/7/2012,6/7/2012,6/14/2012,7,0,7
6/7/2012,6/7/2012,6/14/2012,7,0,7
6/7/2012,6/7/2012,6/14/2012,7,0,7
6/7/2012,6/7/2012,6/28/2012,21,0,21
6/7/2012,6/7/2012,6/28/2012,21,0,21
6/7/2012,6/7/2012,6/13/2012,6,0,6
6/8/2012,6/8/2012,6/13/2012,5,0,5
6/8/2012,6/8/2012,6/11/2012,3,0,3
6/11/2012,6/11/2012,6/12/2012,1,0,1
6/14/2012,6/12/2012,6/21/2012,9,-2,7
6/14/2012,6/12/2012,8/14/2012,63,-2,61
6/12/2012,6/12/2012,6/13/2012,1,0,1
6/12/2012,6/12/2012,6/13/2012,1,0,1
6/12/2012,6/12/2012,6/13/2012,1,0,1
12/20/2013,12/20/2013,12/27/2013,7,0,7
12/20/2013,12/20/2013,12/23/2013,3,0,3
1/24/2014,1/24/2014,1/31/2014,7,0,7
2/6/2014,2/4/2014,3/10/2014,34,-2,32
2/4/2014,2/4/2014,2/11/2014,7,0,7
2/4/2014,2/4/2014,2/11/2014,7,0,7
4/9/2014,4/7/2014,5/9/2014,32,-2,30
4/8/2014,4/8/2014,4/15/2014,7,0,7
4/8/2014,4/8/2014,4/15/2014,7,0,7
4/8/2014,4/8/2014,4/15/2014,7,0,7
4/9/2014,4/8/2014,7/9/2014,92,-1,91
4/9/2014,4/9/2014,5/9/2014,30,0,30
4/9/2014,4/9/2014,7/8/2014,90,0,90
4/9/2014,4/9/2014,7/9/2014,91,0,91
4/9/2014,4/9/2014,5/9/2014,30,0,30
4/11/2014,4/10/2014,5/12/2014,32,-1,31
4/11/2014,4/11/2014,7/8/2014,88,0,88
4/16/2014,4/11/2014,7/16/2014,96,-5,91
4/17/2014,4/17/2014,4/24/2014,7,0,7
4/17/2014,4/17/2014,4/24/2014,7,0,7
4/25/2014,4/25/2014,5/6/2014,11,0,11
4/25/2014,4/25/2014,5/6/2014,11,0,11
4/29/2014,4/29/2014,5/29/2014,30,0,30
4/30/2014,4/30/2014,5/6/2014,6,0,6
4/30/2014,4/30/2014,5/6/2014,6,0,6
5/2/2014,5/2/2014,6/2/2014,31,0,31
5/2/2014,5/2/2014,6/2/2014,31,0,31
12/19/2011,12/19/2011,12/20/2011,1,0,1
12/19/2011,12/19/2011,12/20/2011,1,0,1
12/21/2011,12/19/2011,1/23/2012,35,-2,33
12/22/2011,12/19/2011,1/23/2012,35,-3,32
12/19/2011,12/19/2011,12/20/2011,1,0,1
12/19/2011,12/19/2011,12/20/2011,1,0,1
12/23/2011,12/23/2011,12/28/2011,5,0,5
2/24/2012,2/24/2012,2/27/2012,3,0,3
2/24/2012,2/24/2012,3/2/2012,7,0,7
2/24/2012,2/24/2012,3/2/2012,7,0,7
2/24/2012,2/24/2012,3/2/2012,7,0,7
5/3/2012,5/3/2012,5/10/2012,7,0,7
5/3/2012,5/3/2012,5/4/2012,1,0,1
5/3/2012,5/3/2012,5/10/2012,7,0,7
5/3/2012,5/3/2012,5/10/2012,7,0,7
5/3/2012,5/3/2012,5/4/2012,1,0,1
5/16/2012,5/14/2012,5/30/2012,16,-2,14
5/17/2012,5/15/2012,5/24/2012,9,-2,7
5/18/2012,5/15/2012,8/17/2012,94,-3,91
5/21/2012,5/21/2012,5/22/2012,1,0,1
5/21/2012,5/21/2012,5/22/2012,1,0,1
5/21/2012,5/21/2012,5/22/2012,1,0,1
5/22/2012,5/22/2012,5/23/2012,1,0,1
5/22/2012,5/22/2012,5/23/2012,1,0,1
5/30/2012,5/25/2012,6/6/2012,12,-5,7
5/30/2012,5/25/2012,6/6/2012,12,-5,7
6/13/2012,6/11/2012,6/20/2012,9,-2,7
6/13/2012,6/11/2012,6/20/2012,9,-2,7
6/13/2012,6/11/2012,6/20/2012,9,-2,7
6/14/2012,6/14/2012,7/13/2012,29,0,29
6/14/2012,6/14/2012,6/21/2012,7,0,7
6/14/2012,6/14/2012,6/21/2012,7,0,7
3/19/2014,3/19/2014,4/22/2014,34,0,34
3/20/2014,3/20/2014,3/27/2014,7,0,7
3/20/2014,3/20/2014,3/27/2014,7,0,7
3/20/2014,3/20/2014,6/20/2014,92,0,92
3/21/2014,3/21/2014,4/23/2014,33,0,33
3/21/2014,3/21/2014,3/28/2014,7,0,7
3/21/2014,3/21/2014,3/28/2014,7,0,7
3/21/2014,3/21/2014,3/28/2014,7,0,7
3/21/2014,3/21/2014,3/28/2014,7,0,7
3/26/2014,3/26/2014,4/2/2014,7,0,7
4/3/2014,4/3/2014,4/7/2014,4,0,4
4/3/2014,4/3/2014,4/7/2014,4,0,4
4/3/2014,4/3/2014,4/4/2014,1,0,1
4/4/2014,4/4/2014,4/11/2014,7,0,7
4/4/2014,4/4/2014,4/11/2014,7,0,7
4/14/2014,4/14/2014,7/14/2014,91,0,91
4/14/2014,4/14/2014,4/22/2014,8,0,8
4/14/2014,4/14/2014,4/22/2014,8,0,8
4/15/2014,4/15/2014,5/15/2014,30,0,30
4/15/2014,4/15/2014,4/22/2014,7,0,7
4/22/2014,4/16/2014,5/22/2014,36,-6,30
4/16/2014,4/16/2014,4/23/2014,7,0,7
4/16/2014,4/16/2014,4/23/2014,7,0,7
4/16/2014,4/16/2014,4/23/2014,7,0,7
4/23/2014,4/23/2014,4/30/2014,7,0,7
4/23/2014,4/23/2014,4/30/2014,7,0,7
4/23/2014,4/23/2014,5/23/2014,30,0,30
4/24/2014,4/24/2014,5/2/2014,8,0,8
12/23/2011,12/23/2011,12/28/2011,5,0,5
12/23/2011,12/23/2011,12/27/2011,4,0,4
12/23/2011,12/23/2011,12/27/2011,4,0,4
6/21/2012,6/19/2012,6/28/2012,9,-2,7
6/22/2012,6/21/2012,6/29/2012,8,-1,7
6/22/2012,6/22/2012,6/25/2012,3,0,3
7/19/2012,7/19/2012,7/20/2012,1,0,1
7/16/2012,7/16/2012,7/17/2012,1,0,1
7/16/2012,7/16/2012,7/17/2012,1,0,1
7/16/2012,7/16/2012,7/17/2012,1,0,1
7/30/2012,7/30/2012,7/31/2012,1,0,1
7/30/2012,7/30/2012,7/31/2012,1,0,1
7/19/2012,7/19/2012,8/20/2012,32,0,32
7/20/2012,7/19/2012,7/27/2012,8,-1,7
8/1/2012,7/30/2012,9/3/2012,35,-2,33
8/1/2012,7/30/2012,8/8/2012,9,-2,7
7/30/2012,7/30/2012,8/6/2012,7,0,7
7/31/2012,7/31/2012,8/1/2012,1,0,1
8/6/2012,8/2/2012,11/6/2012,96,-4,92
8/2/2012,8/2/2012,8/9/2012,7,0,7
8/2/2012,8/2/2012,9/4/2012,33,0,33
8/15/2012,8/13/2012,9/14/2012,32,-2,30
8/13/2012,8/13/2012,8/14/2012,1,0,1
8/13/2012,8/13/2012,8/14/2012,1,0,1
8/13/2012,8/13/2012,8/14/2012,1,0,1
8/14/2012,8/14/2012,8/15/2012,1,0,1
8/16/2012,8/14/2012,11/16/2012,94,-2,92
8/16/2012,8/14/2012,9/17/2012,34,-2,32
8/16/2012,8/14/2012,8/23/2012,9,-2,7
8/16/2012,8/16/2012,8/17/2012,1,0,1
5/5/2014,5/5/2014,6/6/2014,32,0,32
5/5/2014,5/5/2014,8/5/2014,92,0,92
5/5/2014,5/5/2014,5/9/2014,4,0,4
5/29/2014,5/29/2014,6/5/2014,7,0,7
5/30/2014,5/29/2014,7/2/2014,34,-1,33
6/3/2014,5/30/2014,9/3/2014,96,-4,92
6/3/2014,5/30/2014,8/4/2014,66,-4,62
6/3/2014,5/30/2014,8/4/2014,66,-4,62
6/3/2014,6/3/2014,6/10/2014,7,0,7
6/3/2014,6/3/2014,9/5/2014,94,0,94
6/10/2014,6/5/2014,9/10/2014,97,-5,92
6/5/2014,6/5/2014,9/9/2014,96,0,96
6/5/2014,6/5/2014,9/9/2014,96,0,96
6/5/2014,6/5/2014,6/12/2014,7,0,7
6/5/2014,6/5/2014,6/12/2014,7,0,7
6/5/2014,6/5/2014,9/5/2014,92,0,92
6/6/2014,6/6/2014,9/8/2014,94,0,94
6/6/2014,6/6/2014,6/13/2014,7,0,7
6/6/2014,6/6/2014,9/10/2014,96,0,96
6/6/2014,6/6/2014,9/9/2014,95,0,95
6/9/2014,6/9/2014,9/12/2014,95,0,95
6/9/2014,6/9/2014,7/14/2014,35,0,35
6/9/2014,6/9/2014,7/14/2014,35,0,35
6/10/2014,6/10/2014,6/17/2014,7,0,7
6/10/2014,6/10/2014,6/17/2014,7,0,7
6/13/2014,6/12/2014,6/19/2014,7,-1,6
6/19/2014,6/19/2014,6/27/2014,8,0,8
6/24/2014,6/20/2014,9/24/2014,96,-4,92
6/20/2014,6/20/2014,9/19/2014,91,0,91
6/20/2014,6/20/2014,9/19/2014,91,0,91
6/20/2014,6/20/2014,6/27/2014,7,0,7
3/21/2012,3/20/2012,3/28/2012,8,-1,7
3/21/2012,3/20/2012,3/28/2012,8,-1,7
3/20/2012,3/20/2012,3/28/2012,8,0,8
3/21/2012,3/20/2012,3/22/2012,2,-1,1
3/21/2012,3/21/2012,3/22/2012,1,0,1
3/21/2012,3/21/2012,4/3/2012,13,0,13
3/23/2012,3/21/2012,3/30/2012,9,-2,7
3/26/2012,3/21/2012,4/2/2012,12,-5,7
3/26/2012,3/21/2012,4/2/2012,12,-5,7
3/26/2012,3/21/2012,6/26/2012,97,-5,92
3/22/2012,3/22/2012,3/29/2012,7,0,7
3/22/2012,3/22/2012,3/29/2012,7,0,7
3/22/2012,3/22/2012,3/23/2012,1,0,1
3/22/2012,3/22/2012,3/23/2012,1,0,1
3/29/2012,3/28/2012,4/10/2012,13,-1,12
3/29/2012,3/29/2012,3/30/2012,1,0,1
3/29/2012,3/29/2012,3/30/2012,1,0,1
3/29/2012,3/29/2012,5/3/2012,35,0,35
3/29/2012,3/29/2012,5/3/2012,35,0,35
4/19/2012,4/19/2012,4/26/2012,7,0,7
4/24/2012,4/20/2012,5/2/2012,12,-4,8
4/20/2012,4/20/2012,4/23/2012,3,0,3
4/20/2012,4/20/2012,4/23/2012,3,0,3
5/18/2012,5/18/2012,6/19/2012,32,0,32
5/18/2012,5/18/2012,5/21/2012,3,0,3
5/18/2012,5/18/2012,5/21/2012,3,0,3
6/14/2012,6/14/2012,6/15/2012,1,0,1
6/18/2012,6/18/2012,6/19/2012,1,0,1
6/18/2012,6/18/2012,6/19/2012,1,0,1
6/18/2012,6/18/2012,6/19/2012,1,0,1
6/19/2012,6/19/2012,6/27/2012,8,0,8
6/20/2012,6/19/2012,6/27/2012,8,-1,7
12/11/2013,12/10/2013,3/11/2014,91,-1,90
12/11/2013,12/11/2013,12/18/2013,7,0,7
12/11/2013,12/11/2013,12/18/2013,7,0,7
12/11/2013,12/11/2013,12/18/2013,7,0,7
12/23/2013,12/23/2013,3/24/2014,91,0,91
12/23/2013,12/23/2013,3/24/2014,91,0,91
12/23/2013,12/23/2013,12/30/2013,7,0,7
12/23/2013,12/23/2013,12/30/2013,7,0,7
12/23/2013,12/23/2013,12/24/2013,1,0,1
12/23/2013,12/23/2013,1/31/2014,39,0,39
12/27/2013,12/26/2013,1/2/2014,7,-1,6
12/27/2013,12/26/2013,2/3/2014,39,-1,38
12/27/2013,12/27/2013,1/2/2014,6,0,6
12/27/2013,12/27/2013,1/3/2014,7,0,7
12/27/2013,12/27/2013,1/3/2014,7,0,7
12/27/2013,12/27/2013,1/3/2014,7,0,7
12/27/2013,12/27/2013,1/3/2014,7,0,7
12/31/2013,12/30/2013,2/3/2014,35,-1,34
12/30/2013,12/30/2013,1/31/2014,32,0,32
12/30/2013,12/30/2013,1/6/2014,7,0,7
1/2/2014,1/2/2014,1/9/2014,7,0,7
1/3/2014,1/3/2014,1/10/2014,7,0,7
1/3/2014,1/3/2014,1/10/2014,7,0,7
2/13/2014,2/12/2014,5/14/2014,91,-1,90
2/18/2014,2/14/2014,3/18/2014,32,-4,28
2/18/2014,2/14/2014,2/25/2014,11,-4,7
3/26/2014,3/24/2014,6/26/2014,94,-2,92
2/29/2012,2/27/2012,3/30/2012,32,-2,30
2/29/2012,2/27/2012,3/7/2012,9,-2,7
2/28/2012,2/28/2012,3/20/2012,21,0,21
2/29/2012,2/29/2012,3/1/2012,1,0,1
2/28/2012,2/28/2012,3/6/2012,7,0,7
2/28/2012,2/28/2012,2/29/2012,1,0,1
2/28/2012,2/28/2012,2/29/2012,1,0,1
2/29/2012,2/29/2012,4/2/2012,33,0,33
2/29/2012,2/29/2012,3/7/2012,7,0,7
5/23/2012,5/21/2012,6/22/2012,32,-2,30
3/2/2012,2/29/2012,3/9/2012,9,-2,7
3/1/2012,3/1/2012,3/2/2012,1,0,1
5/23/2012,5/21/2012,5/30/2012,9,-2,7
5/24/2012,5/23/2012,5/31/2012,8,-1,7
5/24/2012,5/23/2012,5/31/2012,8,-1,7
5/24/2012,5/23/2012,5/31/2012,8,-1,7
5/25/2012,5/24/2012,8/27/2012,95,-1,94
5/24/2012,5/24/2012,5/31/2012,7,0,7
5/24/2012,5/24/2012,5/25/2012,1,0,1
5/24/2012,5/24/2012,5/31/2012,7,0,7
7/19/2012,7/19/2012,7/20/2012,1,0,1
8/22/2012,8/20/2012,8/21/2012,1,-2,-1
8/20/2012,8/20/2012,9/19/2012,30,0,30
8/21/2012,8/21/2012,8/22/2012,1,0,1
8/21/2012,8/21/2012,8/22/2012,1,0,1
8/21/2012,8/21/2012,8/22/2012,1,0,1
8/23/2012,8/21/2012,8/30/2012,9,-2,7
8/30/2012,8/28/2012,9/6/2012,9,-2,7
8/30/2012,8/30/2012,9/6/2012,7,0,7
8/30/2012,8/30/2012,9/6/2012,7,0,7
9/3/2012,8/30/2012,9/28/2012,29,-4,25
8/31/2012,8/31/2012,9/7/2012,7,0,7
6/20/2014,6/20/2014,6/27/2014,7,0,7
6/20/2014,6/20/2014,6/27/2014,7,0,7
6/26/2014,6/24/2014,9/26/2014,94,-2,92
6/27/2014,6/25/2014,9/29/2014,96,-2,94
6/25/2014,6/25/2014,7/7/2014,12,0,12
6/25/2014,6/25/2014,7/2/2014,7,0,7
6/25/2014,6/25/2014,7/2/2014,7,0,7
6/30/2014,6/26/2014,9/30/2014,96,-4,92
6/27/2014,6/27/2014,7/2/2014,5,0,5
6/27/2014,6/27/2014,7/7/2014,10,0,10
6/30/2014,6/30/2014,9/29/2014,91,0,91
6/30/2014,6/30/2014,9/30/2014,92,0,92
6/30/2014,6/30/2014,9/30/2014,92,0,92
6/30/2014,6/30/2014,7/7/2014,7,0,7
6/30/2014,6/30/2014,9/30/2014,92,0,92
7/9/2014,7/9/2014,9/30/2014,83,0,83
7/10/2014,7/10/2014,8/5/2014,26,0,26
7/15/2014,7/11/2014,8/18/2014,38,-4,34
7/11/2014,7/11/2014,7/14/2014,3,0,3
7/11/2014,7/11/2014,8/13/2014,33,0,33
7/11/2014,7/11/2014,8/13/2014,33,0,33
7/11/2014,7/11/2014,8/5/2014,25,0,25
7/14/2014,7/14/2014,10/14/2014,92,0,92
7/14/2014,7/14/2014,7/21/2014,7,0,7
7/16/2014,7/16/2014,8/8/2014,23,0,23
7/16/2014,7/16/2014,8/14/2014,29,0,29
7/16/2014,7/16/2014,8/14/2014,29,0,29
7/16/2014,7/16/2014,7/23/2014,7,0,7
7/17/2014,7/17/2014,8/18/2014,32,0,32
7/18/2014,7/18/2014,7/25/2014,7,0,7
7/22/2014,7/22/2014,7/29/2014,7,0,7
7/30/2014,7/30/2014,8/6/2014,7,0,7
1/24/2012,1/20/2012,1/31/2012,11,-4,7
1/20/2012,1/20/2012,1/27/2012,7,0,7
1/20/2012,1/20/2012,1/27/2012,7,0,7
1/20/2012,1/20/2012,1/27/2012,7,0,7
1/20/2012,1/20/2012,1/26/2012,6,0,6
1/20/2012,1/20/2012,1/23/2012,3,0,3
1/20/2012,1/20/2012,1/23/2012,3,0,3
3/13/2012,3/9/2012,3/20/2012,11,-4,7
3/9/2012,3/9/2012,3/12/2012,3,0,3
6/19/2012,6/19/2012,6/27/2012,8,0,8
6/20/2012,6/19/2012,6/25/2012,6,-1,5
6/20/2012,6/19/2012,6/26/2012,7,-1,6
6/19/2012,6/19/2012,6/27/2012,8,0,8
6/20/2012,6/19/2012,6/21/2012,2,-1,1
6/20/2012,6/20/2012,6/21/2012,1,0,1
6/20/2012,6/20/2012,6/21/2012,1,0,1
6/22/2012,6/22/2012,6/25/2012,3,0,3
6/22/2012,6/22/2012,6/25/2012,3,0,3
6/27/2012,6/25/2012,7/3/2012,8,-2,6
6/27/2012,6/25/2012,7/5/2012,10,-2,8
6/27/2012,6/25/2012,7/3/2012,8,-2,6
6/27/2012,6/25/2012,7/3/2012,8,-2,6
6/29/2012,6/26/2012,8/3/2012,38,-3,35
6/28/2012,6/28/2012,7/5/2012,7,0,7
6/28/2012,6/28/2012,6/29/2012,1,0,1
6/28/2012,6/28/2012,6/29/2012,1,0,1
6/28/2012,6/28/2012,6/29/2012,1,0,1
6/29/2012,6/29/2012,7/2/2012,3,0,3
6/29/2012,6/29/2012,7/2/2012,3,0,3
6/29/2012,6/29/2012,7/2/2012,3,0,3
6/29/2012,6/29/2012,7/2/2012,3,0,3
8/3/2012,8/1/2012,8/10/2012,9,-2,7
8/6/2012,8/2/2012,8/13/2012,11,-4,7
8/7/2012,8/3/2012,11/7/2012,96,-4,92
8/3/2012,8/3/2012,8/6/2012,3,0,3
2/12/2014,2/12/2014,5/12/2014,89,0,89
2/12/2014,2/12/2014,3/19/2014,35,0,35
2/12/2014,2/12/2014,3/12/2014,28,0,28
2/13/2014,2/13/2014,2/20/2014,7,0,7
2/13/2014,2/13/2014,2/20/2014,7,0,7
2/13/2014,2/13/2014,2/20/2014,7,0,7
2/18/2014,2/14/2014,3/18/2014,32,-4,28
2/24/2014,2/24/2014,4/25/2014,60,0,60
2/24/2014,2/24/2014,3/3/2014,7,0,7
2/27/2014,2/25/2014,5/27/2014,91,-2,89
2/27/2014,2/25/2014,4/28/2014,62,-2,60
2/27/2014,2/26/2014,5/30/2014,93,-1,92
5/5/2014,2/26/2014,5/28/2014,91,-68,23
3/27/2014,3/27/2014,4/3/2014,7,0,7
3/27/2014,3/27/2014,4/3/2014,7,0,7
3/28/2014,3/28/2014,4/4/2014,7,0,7
3/28/2014,3/28/2014,4/4/2014,7,0,7
3/28/2014,3/28/2014,4/4/2014,7,0,7
3/28/2014,3/28/2014,4/7/2014,10,0,10
3/31/2014,3/31/2014,5/2/2014,32,0,32
3/31/2014,3/31/2014,5/2/2014,32,0,32
3/31/2014,3/31/2014,4/7/2014,7,0,7
3/31/2014,3/31/2014,4/7/2014,7,0,7
4/3/2014,4/1/2014,6/3/2014,63,-2,61
7/12/2012,7/10/2012,7/19/2012,9,-2,7
7/12/2012,7/12/2012,7/13/2012,1,0,1
7/12/2012,7/12/2012,7/19/2012,7,0,7
7/13/2012,7/13/2012,7/20/2012,7,0,7
7/13/2012,7/13/2012,7/20/2012,7,0,7
7/13/2012,7/13/2012,7/16/2012,3,0,3
9/4/2012,9/4/2012,9/11/2012,7,0,7
9/4/2012,9/4/2012,9/5/2012,1,0,1
9/10/2012,9/10/2012,9/11/2012,1,0,1
9/11/2012,9/11/2012,9/12/2012,1,0,1
9/11/2012,9/11/2012,9/12/2012,1,0,1
9/11/2012,9/11/2012,9/12/2012,1,0,1
9/11/2012,9/11/2012,9/18/2012,7,0,7
9/14/2012,9/12/2012,9/28/2012,16,-2,14
9/12/2012,9/12/2012,9/13/2012,1,0,1
9/12/2012,9/12/2012,9/13/2012,1,0,1
9/13/2012,9/13/2012,9/20/2012,7,0,7
9/13/2012,9/13/2012,9/20/2012,7,0,7
9/21/2012,9/19/2012,12/21/2012,93,-2,91
9/21/2012,9/19/2012,9/28/2012,9,-2,7
9/20/2012,9/20/2012,9/27/2012,7,0,7
9/20/2012,9/20/2012,9/27/2012,7,0,7
9/24/2012,9/20/2012,10/24/2012,34,-4,30
1/6/2014,1/6/2014,1/13/2014,7,0,7
1/7/2014,1/7/2014,1/15/2014,8,0,8
1/7/2014,1/7/2014,1/15/2014,8,0,8
1/9/2014,1/9/2014,2/12/2014,34,0,34
1/9/2014,1/9/2014,1/16/2014,7,0,7
7/30/2014,7/30/2014,8/6/2014,7,0,7
8/1/2014,7/30/2014,9/1/2014,33,-2,31
8/4/2014,7/31/2014,10/6/2014,67,-4,63
8/4/2014,8/1/2014,9/4/2014,34,-3,31
8/1/2014,8/1/2014,8/15/2014,14,0,14
8/1/2014,8/1/2014,9/3/2014,33,0,33
8/1/2014,8/1/2014,8/4/2014,3,0,3
8/1/2014,8/1/2014,8/8/2014,7,0,7
8/4/2014,8/4/2014,9/4/2014,31,0,31
8/4/2014,8/4/2014,9/4/2014,31,0,31
8/4/2014,8/4/2014,8/11/2014,7,0,7
8/4/2014,8/4/2014,9/8/2014,35,0,35
8/6/2014,8/5/2014,11/7/2014,94,-1,93
8/5/2014,8/5/2014,11/5/2014,92,0,92
8/6/2014,8/6/2014,8/13/2014,7,0,7
8/12/2014,8/8/2014,11/12/2014,96,-4,92
8/11/2014,8/11/2014,8/18/2014,7,0,7
8/11/2014,8/11/2014,8/18/2014,7,0,7
8/11/2014,8/11/2014,8/18/2014,7,0,7
8/12/2014,8/12/2014,11/12/2014,92,0,92
8/12/2014,8/12/2014,8/19/2014,7,0,7
8/12/2014,8/12/2014,8/18/2014,6,0,6
8/14/2014,8/14/2014,11/14/2014,92,0,92
2/27/2012,2/23/2012,3/5/2012,11,-4,7
8/13/2012,8/9/2012,9/13/2012,35,-4,31
8/13/2012,8/9/2012,8/28/2012,19,-4,15
8/14/2012,8/10/2012,11/14/2012,96,-4,92
9/27/2012,9/25/2012,11/28/2012,64,-2,62
9/27/2012,9/25/2012,11/1/2012,37,-2,35
10/23/2012,10/23/2012,10/24/2012,1,0,1
11/28/2012,11/26/2012,12/28/2012,32,-2,30
11/28/2012,11/26/2012,2/1/2013,67,-2,65
11/29/2012,11/27/2012,12/31/2012,34,-2,32
11/27/2012,11/27/2012,12/4/2012,7,0,7
11/27/2012,11/27/2012,12/4/2012,7,0,7
11/27/2012,11/27/2012,11/28/2012,1,0,1
11/27/2012,11/27/2012,11/28/2012,1,0,1
11/27/2012,11/27/2012,11/28/2012,1,0,1
11/28/2012,11/28/2012,11/29/2012,1,0,1
11/28/2012,11/28/2012,11/29/2012,1,0,1
11/28/2012,11/28/2012,11/29/2012,1,0,1
12/4/2012,11/30/2012,12/11/2012,11,-4,7
12/10/2012,12/10/2012,12/17/2012,7,0,7
12/10/2012,12/10/2012,12/11/2012,1,0,1
12/10/2012,12/10/2012,12/11/2012,1,0,1
12/10/2012,12/10/2012,12/11/2012,1,0,1
12/11/2012,12/11/2012,12/17/2012,6,0,6
12/11/2012,12/11/2012,12/17/2012,6,0,6
12/11/2012,12/11/2012,12/12/2012,1,0,1
2/5/2014,2/5/2014,5/5/2014,89,0,89
2/5/2014,2/5/2014,3/5/2014,28,0,28
2/10/2014,2/6/2014,3/10/2014,32,-4,28
2/10/2014,2/6/2014,3/10/2014,32,-4,28
2/6/2014,2/6/2014,2/13/2014,7,0,7
2/7/2014,2/7/2014,5/9/2014,91,0,91
2/7/2014,2/7/2014,5/8/2014,90,0,90
3/6/2014,3/4/2014,6/6/2014,94,-2,92
3/7/2014,3/7/2014,3/14/2014,7,0,7
3/10/2014,3/10/2014,4/9/2014,30,0,30
3/10/2014,3/10/2014,6/5/2014,87,0,87
3/10/2014,3/10/2014,3/26/2014,16,0,16
4/24/2014,4/24/2014,5/2/2014,8,0,8
5/5/2014,4/24/2014,6/30/2014,67,-11,56
5/7/2014,5/2/2014,8/7/2014,97,-5,92
5/5/2014,5/5/2014,5/6/2014,1,0,1
5/6/2014,5/6/2014,5/13/2014,7,0,7
5/6/2014,5/6/2014,8/13/2014,99,0,99
5/6/2014,5/6/2014,8/5/2014,91,0,91
5/9/2014,5/7/2014,6/9/2014,33,-2,31
5/7/2014,5/7/2014,5/23/2014,16,0,16
5/7/2014,5/7/2014,5/14/2014,7,0,7
5/8/2014,5/8/2014,8/13/2014,97,0,97
5/13/2014,5/9/2014,8/13/2014,96,-4,92
5/13/2014,5/9/2014,8/13/2014,96,-4,92
5/12/2014,5/9/2014,8/12/2014,95,-3,92
5/12/2014,5/12/2014,8/12/2014,92,0,92
12/21/2011,12/21/2011,12/22/2011,1,0,1
12/21/2011,12/21/2011,12/22/2011,1,0,1
12/21/2011,12/21/2011,12/22/2011,1,0,1
1/27/2012,1/27/2012,1/30/2012,3,0,3
8/23/2012,8/23/2012,8/24/2012,1,0,1
8/23/2012,8/23/2012,8/24/2012,1,0,1
8/24/2012,8/24/2012,8/27/2012,3,0,3
9/24/2012,9/24/2012,9/25/2012,1,0,1
9/25/2012,9/25/2012,9/27/2012,2,0,2
9/25/2012,9/25/2012,9/27/2012,2,0,2
9/25/2012,9/25/2012,9/26/2012,1,0,1
9/26/2012,9/26/2012,9/27/2012,1,0,1
10/2/2012,9/28/2012,12/3/2012,66,-4,62
10/2/2012,9/28/2012,10/9/2012,11,-4,7
10/2/2012,10/2/2012,10/9/2012,7,0,7
10/2/2012,10/2/2012,10/3/2012,1,0,1
10/4/2012,10/3/2012,11/5/2012,33,-1,32
10/4/2012,10/4/2012,11/5/2012,32,0,32
10/5/2012,10/5/2012,10/9/2012,4,0,4
10/5/2012,10/5/2012,10/9/2012,4,0,4
10/16/2012,10/11/2012,12/11/2012,61,-5,56
10/16/2012,10/11/2012,10/12/2012,1,-5,-4
1/16/2014,1/15/2014,5/15/2014,120,-1,119
1/16/2014,1/16/2014,2/18/2014,33,0,33
1/16/2014,1/16/2014,1/23/2014,7,0,7
1/16/2014,1/16/2014,1/23/2014,7,0,7
1/16/2014,1/16/2014,2/20/2014,35,0,35
4/4/2014,4/2/2014,5/5/2014,33,-2,31
4/2/2014,4/2/2014,4/9/2014,7,0,7
4/7/2014,4/3/2014,5/7/2014,34,-4,30
8/14/2014,8/14/2014,11/14/2014,92,0,92
8/14/2014,8/14/2014,9/12/2014,29,0,29
8/14/2014,8/14/2014,9/12/2014,29,0,29
8/14/2014,8/14/2014,8/18/2014,4,0,4
8/15/2014,8/15/2014,8/22/2014,7,0,7
8/20/2014,8/19/2014,9/22/2014,34,-1,33
8/20/2014,8/20/2014,8/27/2014,7,0,7
8/22/2014,8/22/2014,8/29/2014,7,0,7
8/22/2014,8/22/2014,8/29/2014,7,0,7
8/22/2014,8/22/2014,11/21/2014,91,0,91
8/22/2014,8/22/2014,11/21/2014,91,0,91
8/22/2014,8/22/2014,9/30/2014,39,0,39
8/25/2014,8/25/2014,11/25/2014,92,0,92
8/27/2014,8/27/2014,9/3/2014,7,0,7
8/27/2014,8/27/2014,9/26/2014,30,0,30
8/27/2014,8/27/2014,11/28/2014,93,0,93
8/28/2014,8/28/2014,9/5/2014,8,0,8
9/4/2014,9/2/2014,10/6/2014,34,-2,32
9/10/2014,9/8/2014,12/10/2014,93,-2,91
10/9/2014,9/11/2014,12/8/2014,88,-28,60
9/29/2014,9/26/2014,12/19/2014,84,-3,81
12/9/2011,12/9/2011,12/12/2011,3,0,3
12/9/2011,12/9/2011,12/12/2011,3,0,3
6/19/2012,6/19/2012,6/20/2012,1,0,1
6/19/2012,6/19/2012,6/20/2012,1,0,1
6/19/2012,6/19/2012,6/25/2012,6,0,6
6/21/2012,6/21/2012,7/24/2012,33,0,33
6/21/2012,6/21/2012,6/26/2012,5,0,5
6/21/2012,6/21/2012,6/28/2012,7,0,7
6/21/2012,6/21/2012,6/28/2012,7,0,7
6/21/2012,6/21/2012,6/28/2012,7,0,7
6/21/2012,6/21/2012,6/28/2012,7,0,7
6/21/2012,6/21/2012,6/22/2012,1,0,1
6/26/2012,6/22/2012,9/26/2012,96,-4,92
12/11/2012,12/11/2012,12/12/2012,1,0,1
12/11/2012,12/11/2012,12/12/2012,1,0,1
12/11/2012,12/11/2012,12/12/2012,1,0,1
12/12/2012,12/12/2012,12/13/2012,1,0,1
12/12/2012,12/12/2012,12/13/2012,1,0,1
12/17/2012,12/13/2012,3/18/2013,95,-4,91
12/17/2012,12/14/2012,12/24/2012,10,-3,7
12/17/2012,12/17/2012,12/21/2012,4,0,4
12/17/2012,12/17/2012,12/18/2012,1,0,1
12/17/2012,12/17/2012,12/18/2012,1,0,1
12/19/2012,12/19/2012,12/20/2012,1,0,1
12/19/2012,12/19/2012,12/20/2012,1,0,1
5/12/2014,5/12/2014,5/16/2014,4,0,4
5/12/2014,5/12/2014,5/16/2014,4,0,4
5/12/2014,5/12/2014,8/5/2014,85,0,85
5/12/2014,5/12/2014,5/19/2014,7,0,7
5/19/2014,5/15/2014,6/19/2014,35,-4,31
5/19/2014,5/15/2014,8/19/2014,96,-4,92
5/19/2014,5/19/2014,8/19/2014,92,0,92
5/22/2014,5/20/2014,6/23/2014,34,-2,32
5/26/2014,5/23/2014,8/27/2014,96,-3,93
5/27/2014,5/27/2014,6/3/2014,7,0,7
5/27/2014,5/27/2014,6/3/2014,7,0,7
5/23/2014,5/23/2014,5/30/2014,7,0,7
5/23/2014,5/23/2014,5/30/2014,7,0,7
5/27/2014,5/27/2014,6/26/2014,30,0,30
5/27/2014,5/27/2014,6/26/2014,30,0,30
5/30/2014,5/28/2014,8/29/2014,93,-2,91
5/30/2014,5/28/2014,8/29/2014,93,-2,91
5/28/2014,5/28/2014,6/4/2014,7,0,7
5/28/2014,5/28/2014,6/4/2014,7,0,7
5/29/2014,5/28/2014,6/4/2014,7,-1,6
5/29/2014,5/29/2014,6/13/2014,15,0,15
5/30/2014,5/30/2014,6/30/2014,31,0,31
5/30/2014,5/30/2014,6/30/2014,31,0,31
5/30/2014,5/30/2014,6/6/2014,7,0,7
5/30/2014,5/30/2014,6/6/2014,7,0,7
6/2/2014,6/2/2014,6/6/2014,4,0,4
6/2/2014,6/2/2014,6/6/2014,4,0,4
6/2/2014,6/2/2014,7/2/2014,30,0,30
10/12/2012,10/12/2012,10/15/2012,3,0,3
10/12/2012,10/12/2012,10/26/2012,14,0,14
10/24/2012,10/22/2012,11/26/2012,35,-2,33
10/24/2012,10/22/2012,11/26/2012,35,-2,33
10/23/2012,10/23/2012,10/30/2012,7,0,7
10/23/2012,10/23/2012,10/30/2012,7,0,7
10/24/2012,10/24/2012,10/31/2012,7,0,7
10/24/2012,10/24/2012,10/25/2012,1,0,1
10/29/2012,10/25/2012,2/1/2013,99,-4,95
10/26/2012,10/25/2012,11/29/2012,35,-1,34
10/25/2012,10/25/2012,10/26/2012,1,0,1
10/26/2012,10/26/2012,10/29/2012,3,0,3
10/26/2012,10/26/2012,10/29/2012,3,0,3
10/26/2012,10/26/2012,10/29/2012,3,0,3
10/26/2012,10/26/2012,11/2/2012,7,0,7
11/5/2012,11/5/2012,12/5/2012,30,0,30
11/5/2012,11/5/2012,11/6/2012,1,0,1
11/5/2012,11/5/2012,11/6/2012,1,0,1
11/5/2012,11/5/2012,11/6/2012,1,0,1
11/13/2012,11/8/2012,2/11/2013,95,-5,90
11/12/2012,11/8/2012,12/12/2012,34,-4,30
11/9/2012,11/8/2012,2/11/2013,95,-1,94
11/13/2012,11/9/2012,2/13/2013,96,-4,92
11/14/2012,11/12/2012,2/14/2013,94,-2,92
11/13/2012,11/13/2012,12/12/2012,29,0,29
11/15/2012,11/13/2012,11/20/2012,7,-2,5
11/13/2012,11/13/2012,11/14/2012,1,0,1
11/15/2012,11/13/2012,11/14/2012,1,-2,-1
11/15/2012,11/13/2012,11/14/2012,1,-2,-1
12/3/2013,12/3/2013,12/10/2013,7,0,7
12/4/2013,12/4/2013,12/11/2013,7,0,7
12/4/2013,12/4/2013,12/11/2013,7,0,7
12/4/2013,12/4/2013,12/11/2013,7,0,7
4/7/2014,4/7/2014,4/14/2014,7,0,7
4/7/2014,4/7/2014,4/14/2014,7,0,7
4/7/2014,4/7/2014,4/14/2014,7,0,7
4/7/2014,4/7/2014,7/9/2014,93,0,93
4/9/2014,4/7/2014,7/10/2014,94,-2,92
4/9/2014,4/8/2014,5/12/2014,34,-1,33
4/9/2014,4/8/2014,5/12/2014,34,-1,33
4/9/2014,4/8/2014,7/9/2014,92,-1,91
4/9/2014,4/8/2014,5/9/2014,31,-1,30
4/9/2014,4/9/2014,5/9/2014,30,0,30
4/9/2014,4/9/2014,5/9/2014,30,0,30
4/9/2014,4/9/2014,4/16/2014,7,0,7
4/9/2014,4/9/2014,5/9/2014,30,0,30
4/11/2014,4/11/2014,4/22/2014,11,0,11
4/11/2014,4/11/2014,4/22/2014,11,0,11
4/14/2014,4/11/2014,7/14/2014,94,-3,91
4/22/2014,4/22/2014,5/21/2014,29,0,29
4/22/2014,4/22/2014,5/21/2014,29,0,29
4/22/2014,4/22/2014,4/25/2014,3,0,3
4/22/2014,4/22/2014,4/25/2014,3,0,3
12/15/2011,12/15/2011,12/19/2011,4,0,4
12/15/2011,12/15/2011,12/19/2011,4,0,4
12/20/2012,12/20/2012,12/21/2012,1,0,1
12/20/2012,12/20/2012,12/21/2012,1,0,1
12/20/2012,12/20/2012,12/21/2012,1,0,1
12/20/2012,12/20/2012,1/24/2013,35,0,35
12/28/2012,12/21/2012,2/1/2013,42,-7,35
12/21/2012,12/21/2012,3/21/2013,90,0,90
12/21/2012,12/21/2012,1/25/2013,35,0,35
12/21/2012,12/21/2012,12/24/2012,3,0,3
12/21/2012,12/21/2012,12/24/2012,3,0,3
12/21/2012,12/21/2012,12/24/2012,3,0,3
12/24/2012,12/24/2012,12/27/2012,3,0,3
12/24/2012,12/24/2012,12/31/2012,7,0,7
12/26/2012,12/26/2012,1/3/2013,8,0,8
12/31/2012,12/27/2012,2/1/2013,36,-4,32
1/2/2013,1/2/2013,1/3/2013,1,0,1
1/2/2013,1/2/2013,1/3/2013,1,0,1
1/2/2013,1/2/2013,1/3/2013,1,0,1
1/3/2013,1/3/2013,1/4/2013,1,0,1
1/3/2013,1/3/2013,1/9/2013,6,0,6
1/4/2013,1/4/2013,1/11/2013,7,0,7
1/4/2013,1/4/2013,1/11/2013,7,0,7
1/4/2013,1/4/2013,1/11/2013,7,0,7
1/4/2013,1/4/2013,1/17/2013,13,0,13
1/4/2013,1/4/2013,1/7/2013,3,0,3
1/4/2013,1/4/2013,1/7/2013,3,0,3
1/22/2013,1/22/2013,1/29/2013,7,0,7
1/28/2014,1/28/2014,2/4/2014,7,0,7
1/28/2014,1/28/2014,2/4/2014,7,0,7
1/31/2014,1/31/2014,2/7/2014,7,0,7
1/31/2014,1/31/2014,3/5/2014,33,0,33
6/2/2014,6/2/2014,7/2/2014,30,0,30
6/5/2014,6/3/2014,8/5/2014,63,-2,61
6/3/2014,6/3/2014,9/3/2014,92,0,92
6/6/2014,6/4/2014,9/8/2014,96,-2,94
6/4/2014,6/4/2014,6/11/2014,7,0,7
6/6/2014,6/4/2014,9/5/2014,93,-2,91
6/6/2014,6/6/2014,9/5/2014,91,0,91
6/12/2014,6/10/2014,9/12/2014,94,-2,92
6/12/2014,6/10/2014,7/15/2014,35,-2,33
6/12/2014,6/10/2014,7/15/2014,35,-2,33
6/11/2014,6/11/2014,6/18/2014,7,0,7
6/11/2014,6/11/2014,7/11/2014,30,0,30
6/12/2014,6/12/2014,7/15/2014,33,0,33
6/13/2014,6/13/2014,6/20/2014,7,0,7
6/13/2014,6/13/2014,6/20/2014,7,0,7
6/13/2014,6/13/2014,6/20/2014,7,0,7
6/16/2014,6/16/2014,7/16/2014,30,0,30
6/16/2014,6/16/2014,7/16/2014,30,0,30
6/19/2014,6/17/2014,7/21/2014,34,-2,32
6/17/2014,6/17/2014,7/16/2014,29,0,29
6/17/2014,6/17/2014,6/24/2014,7,0,7
6/18/2014,6/18/2014,6/25/2014,7,0,7
6/18/2014,6/18/2014,6/25/2014,7,0,7
6/23/2014,6/20/2014,7/23/2014,33,-3,30
6/23/2014,6/20/2014,9/23/2014,95,-3,92
9/26/2012,9/24/2012,12/27/2012,94,-2,92
9/26/2012,9/26/2012,10/3/2012,7,0,7
9/28/2012,9/26/2012,10/29/2012,33,-2,31
9/28/2012,9/26/2012,11/2/2012,37,-2,35
9/27/2012,9/27/2012,11/1/2012,35,0,35
9/27/2012,9/27/2012,9/28/2012,1,0,1
9/28/2012,9/28/2012,10/12/2012,14,0,14
9/28/2012,9/28/2012,10/5/2012,7,0,7
10/9/2012,10/9/2012,10/16/2012,7,0,7
10/16/2012,10/9/2012,12/11/2012,63,-7,56
10/16/2012,10/9/2012,11/12/2012,34,-7,27
10/10/2012,10/10/2012,10/17/2012,7,0,7
10/10/2012,10/10/2012,10/11/2012,1,0,1
10/10/2012,10/10/2012,10/11/2012,1,0,1
10/10/2012,10/10/2012,10/11/2012,1,0,1
10/10/2012,10/10/2012,10/18/2012,8,0,8
10/16/2012,10/16/2012,10/17/2012,1,0,1
10/16/2012,10/16/2012,10/17/2012,1,0,1
10/16/2012,10/16/2012,10/17/2012,1,0,1
10/17/2012,10/17/2012,11/19/2012,33,0,33
10/17/2012,10/17/2012,11/16/2012,30,0,30
10/18/2012,10/18/2012,10/19/2012,1,0,1
10/18/2012,10/18/2012,10/25/2012,7,0,7
10/18/2012,10/18/2012,10/25/2012,7,0,7
10/19/2012,10/19/2012,11/16/2012,28,0,28
10/19/2012,10/19/2012,11/16/2012,28,0,28
10/19/2012,10/19/2012,10/22/2012,3,0,3
10/19/2012,10/19/2012,10/22/2012,3,0,3
10/29/2012,10/29/2012,11/29/2012,31,0,31
10/29/2012,10/29/2012,10/31/2012,2,0,2
10/29/2012,10/29/2012,10/31/2012,2,0,2
10/31/2012,10/30/2012,11/7/2012,8,-1,7
11/2/2012,10/31/2012,12/28/2012,58,-2,56
11/2/2012,10/31/2012,12/3/2012,33,-2,31
10/31/2012,10/31/2012,11/1/2012,1,0,1
10/31/2012,10/31/2012,11/1/2012,1,0,1
10/31/2012,10/31/2012,11/7/2012,7,0,7
11/5/2012,11/1/2012,12/5/2012,34,-4,30
11/5/2012,11/1/2012,12/5/2012,34,-4,30
11/1/2012,11/1/2012,2/1/2013,92,0,92
11/1/2012,11/1/2012,2/1/2013,92,0,92
11/1/2012,11/1/2012,11/29/2012,28,0,28
11/1/2012,11/1/2012,12/3/2012,32,0,32
10/3/2012,10/3/2012,10/10/2012,7,0,7
10/3/2012,10/3/2012,10/4/2012,1,0,1
10/3/2012,10/3/2012,10/4/2012,1,0,1
10/4/2012,10/4/2012,10/5/2012,1,0,1
10/4/2012,10/4/2012,10/5/2012,1,0,1
10/5/2012,10/5/2012,12/7/2012,63,0,63
10/5/2012,10/5/2012,11/5/2012,31,0,31
10/9/2012,10/5/2012,10/16/2012,11,-4,7
10/9/2012,10/9/2012,10/10/2012,1,0,1
10/9/2012,10/9/2012,10/10/2012,1,0,1
10/9/2012,10/9/2012,10/10/2012,1,0,1
10/16/2012,10/12/2012,10/23/2012,11,-4,7
10/12/2012,10/12/2012,10/19/2012,7,0,7
10/15/2012,10/15/2012,10/16/2012,1,0,1
10/15/2012,10/15/2012,10/16/2012,1,0,1
10/16/2012,10/16/2012,10/23/2012,7,0,7
11/1/2012,11/1/2012,12/3/2012,32,0,32
11/1/2012,11/1/2012,11/2/2012,1,0,1
11/1/2012,11/1/2012,11/2/2012,1,0,1
11/1/2012,11/1/2012,11/2/2012,1,0,1
11/1/2012,11/1/2012,11/8/2012,7,0,7
11/2/2012,11/1/2012,12/4/2012,33,-1,32
11/13/2012,11/13/2012,11/14/2012,1,0,1
11/13/2012,11/12/2012,11/13/2012,1,-1,0
11/14/2012,11/14/2012,2/14/2013,92,0,92
11/14/2012,11/14/2012,11/15/2012,1,0,1
11/14/2012,11/14/2012,11/15/2012,1,0,1
10/25/2012,10/25/2012,11/2/2012,8,0,8
10/29/2012,10/29/2012,11/6/2012,8,0,8
11/14/2012,11/14/2012,11/20/2012,6,0,6
11/15/2012,11/15/2012,11/16/2012,1,0,1
11/15/2012,11/15/2012,11/16/2012,1,0,1
11/20/2012,11/16/2012,11/27/2012,11,-4,7
11/19/2012,11/19/2012,11/20/2012,1,0,1
11/19/2012,11/19/2012,11/20/2012,1,0,1
11/19/2012,11/19/2012,11/20/2012,1,0,1
11/22/2012,11/20/2012,11/30/2012,10,-2,8
11/29/2012,11/29/2012,12/28/2012,29,0,29
11/20/2012,11/20/2012,11/27/2012,7,0,7
11/20/2012,11/20/2012,11/21/2012,1,0,1
11/20/2012,11/20/2012,11/21/2012,1,0,1
11/20/2012,11/20/2012,11/21/2012,1,0,1
11/29/2012,11/27/2012,2/28/2013,93,-2,91
11/29/2012,11/29/2012,11/30/2012,1,0,1
11/29/2012,11/29/2012,11/30/2012,1,0,1
11/29/2012,11/29/2012,11/30/2012,1,0,1
11/29/2012,11/29/2012,11/30/2012,1,0,1
12/3/2012,11/29/2012,12/10/2012,11,-4,7
12/4/2012,12/4/2012,12/5/2012,1,0,1
12/5/2012,12/3/2012,12/28/2012,25,-2,23
12/5/2012,12/3/2012,12/28/2012,25,-2,23
12/4/2012,12/4/2012,12/11/2012,7,0,7
12/4/2012,12/4/2012,12/11/2012,7,0,7
10/17/2012,10/17/2012,10/24/2012,7,0,7
11/2/2012,11/2/2012,11/9/2012,7,0,7
11/2/2012,11/2/2012,11/9/2012,7,0,7
11/2/2012,11/2/2012,11/5/2012,3,0,3
11/2/2012,11/2/2012,11/5/2012,3,0,3
11/9/2012,11/9/2012,3/8/2013,119,0,119
11/9/2012,11/9/2012,11/16/2012,7,0,7
11/9/2012,11/9/2012,11/16/2012,7,0,7
11/9/2012,11/9/2012,11/16/2012,7,0,7
11/9/2012,11/9/2012,11/13/2012,4,0,4
11/9/2012,11/9/2012,11/13/2012,4,0,4
11/9/2012,11/9/2012,11/13/2012,4,0,4
12/4/2012,12/4/2012,12/5/2012,1,0,1
12/10/2012,12/6/2012,12/31/2012,25,-4,21
12/11/2012,12/7/2012,12/18/2012,11,-4,7
12/11/2012,12/7/2012,2/11/2013,66,-4,62
12/7/2012,12/7/2012,12/11/2012,4,0,4
12/7/2012,12/7/2012,12/10/2012,3,0,3
12/7/2012,12/7/2012,12/10/2012,3,0,3
1/17/2013,1/17/2013,2/19/2013,33,0,33
2/6/2013,2/4/2013,5/7/2013,92,-2,90
2/4/2013,2/4/2013,5/2/2013,87,0,87
2/4/2013,2/4/2013,3/28/2013,52,0,52
2/4/2013,2/4/2013,3/6/2013,30,0,30
2/6/2013,2/5/2013,5/7/2013,91,-1,90
2/11/2013,2/7/2013,3/11/2013,32,-4,28
2/6/2013,2/6/2013,3/8/2013,30,0,30
2/6/2013,2/6/2013,3/8/2013,30,0,30
2/12/2013,2/12/2013,2/19/2013,7,0,7
11/19/2012,11/19/2012,12/21/2012,32,0,32
11/21/2012,11/21/2012,11/23/2012,2,0,2
11/21/2012,11/21/2012,11/26/2012,5,0,5
11/22/2012,11/22/2012,11/29/2012,7,0,7
11/23/2012,11/23/2012,2/25/2013,94,0,94
12/3/2012,12/3/2012,12/4/2012,1,0,1
2/26/2013,2/26/2013,3/5/2013,7,0,7
2/27/2013,2/27/2013,3/6/2013,7,0,7
12/3/2012,12/3/2012,12/4/2012,1,0,1
12/3/2012,12/3/2012,12/28/2012,25,0,25
12/3/2012,12/3/2012,12/28/2012,25,0,25
12/3/2012,12/3/2012,12/7/2012,4,0,4
3/4/2013,2/28/2013,6/4/2013,96,-4,92
3/1/2013,3/1/2013,3/8/2013,7,0,7
3/1/2013,3/1/2013,3/8/2013,7,0,7
3/1/2013,3/1/2013,3/8/2013,7,0,7
3/4/2013,3/4/2013,3/28/2013,24,0,24
3/4/2013,3/4/2013,3/28/2013,24,0,24
3/12/2013,3/8/2013,6/12/2013,96,-4,92
12/5/2012,12/5/2012,12/28/2012,23,0,23
12/5/2012,12/5/2012,12/6/2012,1,0,1
12/5/2012,12/5/2012,12/6/2012,1,0,1
12/18/2012,12/18/2012,12/27/2012,9,0,9
12/18/2012,12/18/2012,12/19/2012,1,0,1
12/18/2012,12/18/2012,12/19/2012,1,0,1
12/18/2012,12/18/2012,12/19/2012,1,0,1
12/27/2012,12/27/2012,2/1/2013,36,0,36
12/28/2012,12/27/2012,2/1/2013,36,-1,35
12/27/2012,12/27/2012,1/3/2013,7,0,7
12/27/2012,12/27/2012,12/28/2012,1,0,1
12/27/2012,12/27/2012,12/28/2012,1,0,1
12/31/2012,12/28/2012,2/1/2013,35,-3,32
12/31/2012,12/28/2012,2/4/2013,38,-3,35
1/3/2013,12/31/2012,1/10/2013,10,-3,7
1/14/2013,1/14/2013,2/13/2013,30,0,30
1/28/2013,1/28/2013,2/27/2013,30,0,30
1/16/2013,1/16/2013,1/23/2013,7,0,7
1/17/2013,1/17/2013,2/19/2013,33,0,33
1/17/2013,1/17/2013,2/19/2013,33,0,33
1/22/2013,1/17/2013,1/25/2013,8,-5,3
1/29/2013,1/29/2013,2/5/2013,7,0,7
12/4/2012,12/4/2012,12/5/2012,1,0,1
2/18/2013,2/14/2013,5/21/2013,96,-4,92
2/20/2013,2/19/2013,5/21/2013,91,-1,90
2/19/2013,2/19/2013,3/19/2013,28,0,28
2/20/2013,2/20/2013,3/19/2013,27,0,27
2/25/2013,2/21/2013,5/27/2013,95,-4,91
2/22/2013,2/22/2013,3/1/2013,7,0,7
2/22/2013,2/22/2013,3/1/2013,7,0,7
2/22/2013,2/22/2013,3/1/2013,7,0,7
2/22/2013,2/22/2013,3/22/2013,28,0,28
3/11/2013,3/7/2013,5/7/2013,61,-4,57
3/11/2013,3/7/2013,4/11/2013,35,-4,31
3/11/2013,3/11/2013,3/18/2013,7,0,7
3/11/2013,3/11/2013,3/18/2013,7,0,7
3/27/2013,3/25/2013,6/27/2013,94,-2,92
3/25/2013,3/25/2013,4/2/2013,8,0,8
3/25/2013,3/25/2013,4/2/2013,8,0,8
3/28/2013,3/28/2013,4/2/2013,5,0,5
3/28/2013,3/28/2013,5/2/2013,35,0,35
3/28/2013,3/28/2013,5/28/2013,61,0,61
3/28/2013,3/28/2013,5/28/2013,61,0,61
3/28/2013,3/28/2013,6/24/2013,88,0,88
3/28/2013,3/28/2013,4/4/2013,7,0,7
4/4/2013,3/28/2013,4/2/2013,5,-7,-2
4/2/2013,4/2/2013,4/9/2013,7,0,7
4/29/2013,4/2/2013,4/9/2013,7,-27,-20
4/29/2013,4/2/2013,4/9/2013,7,-27,-20
4/22/2013,4/2/2013,4/8/2013,6,-20,-14
2/13/2013,2/12/2013,8/13/2013,182,-1,181
4/29/2013,4/2/2013,4/8/2013,6,-27,-21
4/29/2013,4/25/2013,6/18/2013,54,-4,50
4/29/2013,4/25/2013,6/25/2013,61,-4,57
4/29/2013,4/25/2013,4/30/2013,5,-4,1
4/26/2013,4/26/2013,6/18/2013,53,0,53
4/26/2013,4/26/2013,6/18/2013,53,0,53
5/15/2013,5/15/2013,6/14/2013,30,0,30
5/15/2013,5/15/2013,5/22/2013,7,0,7
5/16/2013,5/16/2013,6/14/2013,29,0,29
5/21/2013,5/16/2013,8/21/2013,97,-5,92
5/21/2013,5/16/2013,8/21/2013,97,-5,92
5/17/2013,5/16/2013,8/1/2013,77,-1,76
5/17/2013,5/17/2013,5/24/2013,7,0,7
5/17/2013,5/17/2013,6/17/2013,31,0,31
5/17/2013,5/17/2013,5/22/2013,5,0,5
5/17/2013,5/17/2013,5/24/2013,7,0,7
5/17/2013,5/17/2013,6/5/2013,19,0,19
5/28/2013,5/28/2013,8/1/2013,65,0,65
5/28/2013,5/28/2013,6/4/2013,7,0,7
5/28/2013,5/28/2013,6/26/2013,29,0,29
5/28/2013,5/28/2013,6/26/2013,29,0,29
5/31/2013,5/29/2013,8/30/2013,93,-2,91
6/4/2013,6/4/2013,6/7/2013,3,0,3
6/4/2013,6/4/2013,6/7/2013,3,0,3
6/6/2013,6/6/2013,6/13/2013,7,0,7
6/7/2013,6/6/2013,6/26/2013,20,-1,19
6/7/2013,6/7/2013,9/6/2013,91,0,91
6/7/2013,6/7/2013,6/14/2013,7,0,7
6/7/2013,6/7/2013,6/14/2013,7,0,7
6/7/2013,6/7/2013,6/14/2013,7,0,7
6/10/2013,6/10/2013,9/12/2013,94,0,94
6/14/2013,6/12/2013,7/15/2013,33,-2,31
3/12/2013,3/12/2013,4/11/2013,30,0,30
4/4/2013,3/26/2013,6/28/2013,94,-9,85
3/28/2013,3/26/2013,5/28/2013,63,-2,61
3/28/2013,3/26/2013,5/28/2013,63,-2,61
3/27/2013,3/27/2013,4/2/2013,6,0,6
3/28/2013,3/28/2013,4/3/2013,6,0,6
3/28/2013,3/28/2013,4/3/2013,6,0,6
6/14/2013,6/14/2013,6/21/2013,7,0,7
6/14/2013,6/14/2013,6/21/2013,7,0,7
6/14/2013,6/14/2013,6/21/2013,7,0,7
6/18/2013,6/17/2013,6/25/2013,8,-1,7
6/19/2013,6/19/2013,6/26/2013,7,0,7
6/19/2013,6/19/2013,6/26/2013,7,0,7
7/2/2013,7/2/2013,9/5/2013,65,0,65
7/15/2013,7/12/2013,7/19/2013,7,-3,4
7/12/2013,7/12/2013,8/13/2013,32,0,32
7/31/2013,7/31/2013,10/16/2013,77,0,77
7/31/2013,7/31/2013,9/5/2013,36,0,36
7/31/2013,7/31/2013,8/30/2013,30,0,30
8/2/2013,7/31/2013,9/5/2013,36,-2,34
8/1/2013,8/1/2013,9/5/2013,35,0,35
8/1/2013,8/1/2013,10/16/2013,76,0,76
8/5/2013,8/5/2013,11/4/2013,91,0,91
8/6/2013,8/6/2013,11/7/2013,93,0,93
8/6/2013,8/6/2013,8/8/2013,2,0,2
2/1/2013,1/30/2013,3/28/2013,57,-2,55
1/31/2013,1/30/2013,3/1/2013,30,-1,29
1/31/2013,1/30/2013,5/2/2013,92,-1,91
1/31/2013,1/30/2013,3/25/2013,54,-1,53
1/31/2013,1/30/2013,5/3/2013,93,-1,92
4/10/2013,4/10/2013,4/17/2013,7,0,7
2/1/2013,1/31/2013,3/28/2013,56,-1,55
1/31/2013,1/31/2013,3/28/2013,56,0,56
1/31/2013,1/31/2013,3/4/2013,32,0,32
1/31/2013,1/31/2013,5/2/2013,91,0,91
2/1/2013,2/1/2013,5/2/2013,90,0,90
4/10/2013,4/10/2013,5/10/2013,30,0,30
4/15/2013,4/11/2013,5/15/2013,34,-4,30
2/1/2013,2/1/2013,2/8/2013,7,0,7
2/1/2013,2/1/2013,2/8/2013,7,0,7
2/1/2013,2/1/2013,2/8/2013,7,0,7
2/1/2013,2/1/2013,2/28/2013,27,0,27
2/1/2013,2/1/2013,3/28/2013,55,0,55
2/1/2013,2/1/2013,5/2/2013,90,0,90
4/15/2013,4/11/2013,5/15/2013,34,-4,30
4/12/2013,4/12/2013,5/10/2013,28,0,28
4/12/2013,4/12/2013,5/10/2013,28,0,28
4/12/2013,4/12/2013,5/10/2013,28,0,28
4/16/2013,4/16/2013,4/23/2013,7,0,7
4/16/2013,4/16/2013,4/23/2013,7,0,7
4/16/2013,4/16/2013,4/23/2013,7,0,7
4/18/2013,4/18/2013,4/25/2013,7,0,7
6/13/2013,6/11/2013,8/13/2013,63,-2,61
8/7/2013,8/7/2013,8/15/2013,8,0,8
8/7/2013,8/7/2013,11/8/2013,93,0,93
5/15/2013,5/13/2013,6/14/2013,32,-2,30
5/15/2013,5/13/2013,6/17/2013,35,-2,33
6/13/2013,6/13/2013,8/13/2013,61,0,61
6/13/2013,6/13/2013,6/21/2013,8,0,8
6/13/2013,6/13/2013,7/12/2013,29,0,29
6/13/2013,6/13/2013,8/8/2013,56,0,56
6/13/2013,6/13/2013,7/18/2013,35,0,35
6/17/2013,6/17/2013,8/1/2013,45,0,45
6/18/2013,6/18/2013,7/19/2013,31,0,31
6/18/2013,6/18/2013,6/19/2013,1,0,1
6/18/2013,6/18/2013,6/19/2013,1,0,1
6/24/2013,6/20/2013,8/23/2013,64,-4,60
6/24/2013,6/20/2013,8/26/2013,67,-4,63
6/25/2013,6/21/2013,9/25/2013,96,-4,92
6/25/2013,6/21/2013,9/25/2013,96,-4,92
6/21/2013,6/21/2013,6/28/2013,7,0,7
6/21/2013,6/21/2013,6/28/2013,7,0,7
6/21/2013,6/21/2013,6/25/2013,4,0,4
6/21/2013,6/21/2013,8/23/2013,63,0,63
6/24/2013,6/24/2013,6/25/2013,1,0,1
6/24/2013,6/24/2013,8/1/2013,38,0,38
6/25/2013,6/25/2013,6/26/2013,1,0,1
6/27/2013,6/25/2013,9/27/2013,94,-2,92
6/27/2013,6/27/2013,8/2/2013,36,0,36
8/8/2013,8/8/2013,9/13/2013,36,0,36
8/8/2013,8/8/2013,8/19/2013,11,0,11
8/8/2013,8/8/2013,8/19/2013,11,0,11
2/27/2012,2/27/2012,2/28/2012,1,0,1
2/27/2012,2/27/2012,2/28/2012,1,0,1
2/27/2012,2/27/2012,2/28/2012,1,0,1
2/27/2012,2/27/2012,2/28/2012,1,0,1
3/2/2012,3/2/2012,3/5/2012,3,0,3
3/2/2012,3/2/2012,3/9/2012,7,0,7
3/2/2012,3/2/2012,3/9/2012,7,0,7
3/2/2012,3/2/2012,3/9/2012,7,0,7
3/2/2012,3/2/2012,3/5/2012,3,0,3
3/2/2012,3/2/2012,3/5/2012,3,0,3
3/2/2012,3/2/2012,3/5/2012,3,0,3
6/27/2012,6/27/2012,6/28/2012,1,0,1
6/27/2012,6/27/2012,9/26/2012,91,0,91
6/29/2012,6/27/2012,8/1/2012,35,-2,33
6/27/2012,6/27/2012,6/28/2012,1,0,1
6/27/2012,6/27/2012,6/28/2012,1,0,1
6/28/2012,6/28/2012,6/29/2012,1,0,1
7/3/2012,6/29/2012,7/10/2012,11,-4,7
7/9/2012,7/9/2012,7/10/2012,1,0,1
7/10/2012,7/10/2012,7/11/2012,1,0,1
7/10/2012,7/10/2012,7/11/2012,1,0,1
7/10/2012,7/10/2012,8/9/2012,30,0,30
7/11/2012,7/10/2012,8/9/2012,30,-1,29
7/11/2012,7/10/2012,8/13/2012,34,-1,33
7/13/2012,7/11/2012,7/20/2012,9,-2,7
7/11/2012,7/11/2012,7/12/2012,1,0,1
7/11/2012,7/11/2012,7/12/2012,1,0,1
7/13/2012,7/11/2012,8/15/2012,35,-2,33
7/12/2012,7/12/2012,7/19/2012,7,0,7
7/12/2012,7/12/2012,7/19/2012,7,0,7
8/21/2013,8/19/2013,11/21/2013,94,-2,92
8/28/2013,8/23/2013,11/28/2013,97,-5,92
8/23/2013,8/23/2013,8/30/2013,7,0,7
8/30/2013,8/28/2013,11/29/2013,93,-2,91
8/29/2013,8/28/2013,11/29/2013,93,-1,92
8/29/2013,8/28/2013,2/28/2014,184,-1,183
8/28/2013,8/28/2013,8/30/2013,2,0,2
8/28/2013,8/28/2013,8/30/2013,2,0,2
8/29/2013,8/28/2013,10/11/2013,44,-1,43
8/30/2013,8/28/2013,12/2/2013,96,-2,94
10/16/2013,10/16/2013,12/23/2013,68,0,68
10/18/2013,10/17/2013,11/21/2013,35,-1,34
10/18/2013,10/18/2013,1/16/2014,90,0,90
10/18/2013,10/18/2013,10/25/2013,7,0,7
10/22/2013,10/22/2013,10/30/2013,8,0,8
10/22/2013,10/22/2013,10/30/2013,8,0,8
10/25/2013,10/23/2013,11/1/2013,9,-2,7
10/24/2013,10/24/2013,12/27/2013,64,0,64
10/24/2013,10/24/2013,10/31/2013,7,0,7
10/24/2013,10/24/2013,10/31/2013,7,0,7
10/25/2013,10/25/2013,11/1/2013,7,0,7
11/15/2013,11/14/2013,12/16/2013,32,-1,31
11/14/2013,11/14/2013,11/21/2013,7,0,7
11/15/2013,11/15/2013,11/22/2013,7,0,7
11/15/2013,11/15/2013,11/22/2013,7,0,7
3/12/2012,3/12/2012,3/13/2012,1,0,1
3/12/2012,3/12/2012,3/13/2012,1,0,1
3/12/2012,3/12/2012,3/16/2012,4,0,4
3/14/2012,3/13/2012,3/19/2012,6,-1,5
3/14/2012,3/14/2012,3/21/2012,7,0,7
3/14/2012,3/14/2012,3/21/2012,7,0,7
3/14/2012,3/14/2012,4/12/2012,29,0,29
3/14/2012,3/14/2012,3/15/2012,1,0,1
3/14/2012,3/14/2012,3/15/2012,1,0,1
3/19/2012,3/15/2012,3/26/2012,11,-4,7
3/19/2012,3/15/2012,3/26/2012,11,-4,7
3/20/2012,3/16/2012,3/27/2012,11,-4,7
8/14/2013,8/12/2013,11/14/2013,94,-2,92
8/14/2013,8/14/2013,11/14/2013,92,0,92
8/14/2013,8/14/2013,9/16/2013,33,0,33
8/14/2013,8/14/2013,9/18/2013,35,0,35
8/19/2013,8/15/2013,9/19/2013,35,-4,31
8/22/2013,8/22/2013,8/27/2013,5,0,5
8/22/2013,8/22/2013,8/27/2013,5,0,5
8/26/2013,8/23/2013,2/26/2014,187,-3,184
8/23/2013,8/23/2013,10/24/2013,62,0,62
9/4/2013,9/2/2013,12/4/2013,93,-2,91
9/5/2013,9/3/2013,12/5/2013,93,-2,91
9/5/2013,9/3/2013,10/7/2013,34,-2,32
9/5/2013,9/4/2013,12/6/2013,93,-1,92
9/9/2013,9/5/2013,12/9/2013,95,-4,91
9/19/2013,9/17/2013,10/21/2013,34,-2,32
9/3/2013,9/3/2013,9/10/2013,7,0,7
9/3/2013,9/3/2013,9/10/2013,7,0,7
9/4/2013,9/4/2013,9/11/2013,7,0,7
9/5/2013,9/5/2013,9/25/2013,20,0,20
9/5/2013,9/5/2013,9/27/2013,22,0,22
9/5/2013,9/5/2013,9/27/2013,22,0,22
9/5/2013,9/5/2013,10/9/2013,34,0,34
9/5/2013,9/5/2013,10/10/2013,35,0,35
9/5/2013,9/5/2013,10/10/2013,35,0,35
9/24/2013,9/24/2013,1/3/2014,101,0,101
9/24/2013,9/24/2013,12/27/2013,94,0,94
9/25/2013,9/24/2013,12/2/2013,69,-1,68
9/27/2013,9/25/2013,12/27/2013,93,-2,91
9/25/2013,9/25/2013,12/27/2013,93,0,93
9/25/2013,9/25/2013,12/2/2013,68,0,68
9/25/2013,9/25/2013,9/26/2013,1,0,1
9/25/2013,9/25/2013,9/26/2013,1,0,1
9/30/2013,9/27/2013,11/29/2013,63,-3,60
9/30/2013,9/27/2013,11/29/2013,63,-3,60
9/27/2013,9/27/2013,10/4/2013,7,0,7
9/27/2013,9/27/2013,11/1/2013,35,0,35
9/27/2013,9/27/2013,11/1/2013,35,0,35
9/27/2013,9/27/2013,11/1/2013,35,0,35
10/7/2013,10/7/2013,10/15/2013,8,0,8
10/11/2013,10/11/2013,10/18/2013,7,0,7
10/11/2013,10/11/2013,10/31/2013,20,0,20
10/22/2013,10/22/2013,10/29/2013,7,0,7
10/22/2013,10/22/2013,10/29/2013,7,0,7
4/29/2013,4/26/2013,5/29/2013,33,-3,30
6/17/2013,6/13/2013,8/19/2013,67,-4,63
7/3/2013,7/3/2013,8/5/2013,33,0,33
7/3/2013,7/3/2013,8/2/2013,30,0,30
7/8/2013,7/8/2013,9/9/2013,63,0,63
7/8/2013,7/8/2013,7/12/2013,4,0,4
7/8/2013,7/8/2013,7/15/2013,7,0,7
7/15/2013,7/11/2013,8/15/2013,35,-4,31
11/15/2013,11/15/2013,11/22/2013,7,0,7
11/15/2013,11/15/2013,11/22/2013,7,0,7
11/18/2013,11/18/2013,12/18/2013,30,0,30
11/18/2013,11/18/2013,11/25/2013,7,0,7
11/18/2013,11/18/2013,11/25/2013,7,0,7
11/20/2013,11/18/2013,2/20/2014,94,-2,92
11/21/2013,11/19/2013,2/21/2014,94,-2,92
11/21/2013,11/19/2013,2/21/2014,94,-2,92
11/20/2013,11/20/2013,11/27/2013,7,0,7
11/22/2013,11/22/2013,11/25/2013,3,0,3
11/25/2013,11/25/2013,12/2/2013,7,0,7
11/29/2013,11/27/2013,2/28/2014,93,-2,91
11/29/2013,11/27/2013,2/28/2014,93,-2,91
11/29/2013,11/27/2013,2/28/2014,93,-2,91
11/29/2013,11/27/2013,2/28/2014,93,-2,91
11/27/2013,11/27/2013,12/4/2013,7,0,7
11/27/2013,11/27/2013,12/4/2013,7,0,7
11/27/2013,11/27/2013,12/4/2013,7,0,7
9/19/2013,9/19/2013,9/20/2013,1,0,1
9/20/2013,9/20/2013,9/27/2013,7,0,7
9/20/2013,9/20/2013,9/27/2013,7,0,7
9/20/2013,9/20/2013,12/19/2013,90,0,90
9/26/2013,9/26/2013,12/2/2013,67,0,67
9/27/2013,9/27/2013,11/1/2013,35,0,35
10/1/2013,10/1/2013,10/9/2013,8,0,8
11/6/2013,11/5/2013,2/7/2014,94,-1,93
10/16/2013,10/15/2013,12/23/2013,69,-1,68
11/12/2013,11/7/2013,2/12/2014,97,-5,92
11/27/2013,11/25/2013,2/27/2014,94,-2,92
11/26/2013,11/26/2013,12/3/2013,7,0,7
12/2/2013,11/28/2013,3/3/2014,95,-4,91
11/29/2013,11/29/2013,12/30/2013,31,0,31
12/2/2013,12/2/2013,3/4/2014,92,0,92
12/2/2013,12/2/2013,12/30/2013,28,0,28
12/2/2013,12/2/2013,12/30/2013,28,0,28
12/2/2013,12/2/2013,12/6/2013,4,0,4
12/2/2013,12/2/2013,12/6/2013,4,0,4
12/2/2013,12/2/2013,12/4/2013,2,0,2
12/2/2013,12/2/2013,12/3/2013,1,0,1
12/5/2013,12/3/2013,3/5/2014,92,-2,90
12/6/2013,12/3/2013,3/6/2014,93,-3,90
12/5/2013,12/3/2013,3/6/2014,93,-2,91
12/3/2013,12/3/2013,12/9/2013,6,0,6
1/2/2012,1/2/2012,1/3/2012,1,0,1
1/3/2012,1/3/2012,1/4/2012,1,0,1
1/4/2012,1/3/2012,1/26/2012,23,-1,22
1/3/2012,1/3/2012,1/4/2012,1,0,1
1/3/2012,1/3/2012,1/4/2012,1,0,1
1/3/2012,1/3/2012,1/4/2012,1,0,1
1/4/2012,1/4/2012,1/5/2012,1,0,1
1/4/2012,1/4/2012,1/5/2012,1,0,1
1/4/2012,1/4/2012,1/5/2012,1,0,1
1/4/2012,1/4/2012,1/5/2012,1,0,1
1/4/2012,1/4/2012,1/5/2012,1,0,1
1/6/2012,1/5/2012,4/5/2012,91,-1,90
1/6/2012,1/5/2012,2/6/2012,32,-1,31
1/5/2012,1/5/2012,1/6/2012,1,0,1
1/5/2012,1/5/2012,1/6/2012,1,0,1
1/19/2012,1/19/2012,1/20/2012,1,0,1
1/19/2012,1/19/2012,1/20/2012,1,0,1
1/19/2012,1/19/2012,1/20/2012,1,0,1
1/19/2012,1/19/2012,1/20/2012,1,0,1
5/30/2012,5/30/2012,6/6/2012,7,0,7
5/30/2012,5/30/2012,6/29/2012,30,0,30
5/31/2012,5/31/2012,6/1/2012,1,0,1
6/1/2012,6/1/2012,6/8/2012,7,0,7
6/1/2012,6/1/2012,6/7/2012,6,0,6
6/1/2012,6/1/2012,6/4/2012,3,0,3
12/19/2011,12/19/2011,12/20/2011,1,0,1
12/19/2011,12/19/2011,12/20/2011,1,0,1
1/9/2012,1/9/2012,1/10/2012,1,0,1
12/20/2011,12/20/2011,12/21/2011,1,0,1
12/20/2011,12/20/2011,12/21/2011,1,0,1
12/20/2011,12/20/2011,12/21/2011,1,0,1
12/20/2011,12/20/2011,12/21/2011,1,0,1
12/20/2011,12/20/2011,12/21/2011,1,0,1
12/20/2011,12/20/2011,12/21/2011,1,0,1
1/10/2012,1/10/2012,1/11/2012,1,0,1
1/10/2012,1/10/2012,1/11/2012,1,0,1
1/11/2012,1/11/2012,1/12/2012,1,0,1
1/11/2012,1/11/2012,1/12/2012,1,0,1
1/12/2012,1/12/2012,1/13/2012,1,0,1
1/12/2012,1/12/2012,1/13/2012,1,0,1
1/12/2012,1/12/2012,1/13/2012,1,0,1
1/12/2012,1/12/2012,1/13/2012,1,0,1
1/13/2012,1/13/2012,1/17/2012,4,0,4
1/13/2012,1/13/2012,1/20/2012,7,0,7
1/13/2012,1/13/2012,1/17/2012,4,0,4
1/18/2012,1/18/2012,1/24/2012,6,0,6
1/18/2012,1/18/2012,1/27/2012,9,0,9
1/18/2012,1/18/2012,1/19/2012,1,0,1
1/18/2012,1/18/2012,1/19/2012,1,0,1
1/18/2012,1/18/2012,1/19/2012,1,0,1
2/6/2012,2/6/2012,2/7/2012,1,0,1
2/8/2012,2/6/2012,2/15/2012,9,-2,7
5/10/2012,5/10/2012,5/17/2012,7,0,7
5/10/2012,5/10/2012,6/11/2012,32,0,32
5/10/2012,5/10/2012,5/11/2012,1,0,1
5/10/2012,5/10/2012,5/11/2012,1,0,1
5/10/2012,5/10/2012,5/11/2012,1,0,1
8/17/2012,8/14/2012,11/19/2012,97,-3,94
8/16/2012,8/16/2012,8/24/2012,8,0,8
1/17/2012,1/17/2012,1/18/2012,1,0,1
1/17/2012,1/17/2012,1/19/2012,2,0,2
1/18/2012,1/18/2012,1/19/2012,1,0,1
1/17/2012,1/17/2012,1/18/2012,1,0,1
1/17/2012,1/17/2012,1/18/2012,1,0,1
1/17/2012,1/17/2012,1/18/2012,1,0,1
1/17/2012,1/17/2012,1/24/2012,7,0,7
1/18/2012,1/18/2012,1/19/2012,1,0,1
1/18/2012,1/18/2012,1/19/2012,1,0,1
1/23/2012,1/19/2012,2/23/2012,35,-4,31
1/19/2012,1/19/2012,1/26/2012,7,0,7
1/20/2012,1/19/2012,1/27/2012,8,-1,7
1/19/2012,1/19/2012,1/20/2012,1,0,1
1/20/2012,1/20/2012,1/23/2012,3,0,3
1/20/2012,1/20/2012,1/23/2012,3,0,3
8/15/2012,8/15/2012,8/21/2012,6,0,6
8/15/2012,8/15/2012,8/21/2012,6,0,6
8/15/2012,8/15/2012,8/16/2012,1,0,1
8/15/2012,8/15/2012,8/16/2012,1,0,1
8/21/2012,8/17/2012,11/21/2012,96,-4,92
8/21/2012,8/17/2012,8/28/2012,11,-4,7
12/27/2011,12/27/2011,12/28/2011,1,0,1
12/29/2011,12/29/2011,12/30/2011,1,0,1
12/30/2011,12/30/2011,1/3/2012,4,0,4
12/30/2011,12/30/2011,1/3/2012,4,0,4
1/30/2012,1/30/2012,1/31/2012,1,0,1
1/31/2012,1/31/2012,2/28/2012,28,0,28
1/31/2012,1/31/2012,2/27/2012,27,0,27
1/31/2012,1/31/2012,2/1/2012,1,0,1
1/31/2012,1/31/2012,2/1/2012,1,0,1
1/31/2012,1/31/2012,2/1/2012,1,0,1
1/31/2012,1/31/2012,2/7/2012,7,0,7
2/3/2012,2/1/2012,2/6/2012,5,-2,3
2/3/2012,2/1/2012,2/10/2012,9,-2,7
2/6/2012,2/2/2012,2/13/2012,11,-4,7
2/6/2012,2/2/2012,2/13/2012,11,-4,7
2/2/2012,2/2/2012,2/9/2012,7,0,7
2/2/2012,2/2/2012,2/3/2012,1,0,1
2/2/2012,2/2/2012,3/2/2012,29,0,29
7/3/2012,7/2/2012,10/3/2012,93,-1,92
7/5/2012,7/2/2012,8/6/2012,35,-3,32
7/5/2012,7/2/2012,7/12/2012,10,-3,7
7/3/2012,7/3/2012,7/5/2012,2,0,2
7/3/2012,7/3/2012,7/5/2012,2,0,2
7/3/2012,7/3/2012,7/5/2012,2,0,2
7/5/2012,7/3/2012,7/12/2012,9,-2,7
7/5/2012,7/5/2012,7/12/2012,7,0,7
7/5/2012,7/5/2012,7/12/2012,7,0,7
7/5/2012,7/5/2012,7/12/2012,7,0,7
7/5/2012,7/5/2012,7/6/2012,1,0,1
7/5/2012,7/5/2012,7/6/2012,1,0,1
7/5/2012,7/5/2012,7/6/2012,1,0,1
7/6/2012,7/6/2012,7/13/2012,7,0,7
7/6/2012,7/6/2012,7/12/2012,6,0,6
12/12/2011,12/12/2011,2/7/2012,57,0,57
12/12/2011,12/12/2011,12/13/2011,1,0,1
12/13/2011,12/13/2011,12/14/2011,1,0,1
12/13/2011,12/13/2011,12/14/2011,1,0,1
12/13/2011,12/13/2011,12/14/2011,1,0,1
12/14/2011,12/14/2011,12/15/2011,1,0,1
12/14/2011,12/14/2011,12/15/2011,1,0,1
12/22/2011,12/22/2011,12/23/2011,1,0,1
12/22/2011,12/22/2011,12/23/2011,1,0,1
12/22/2011,12/22/2011,12/23/2011,1,0,1
12/22/2011,12/22/2011,12/23/2011,1,0,1
12/22/2011,12/22/2011,12/23/2011,1,0,1
12/22/2011,12/22/2011,12/23/2011,1,0,1
12/22/2011,12/22/2011,12/23/2011,1,0,1
12/28/2011,12/23/2011,1/30/2012,38,-5,33
12/23/2011,12/23/2011,12/27/2011,4,0,4
12/27/2011,12/23/2011,1/3/2012,11,-4,7
2/6/2012,2/6/2012,2/7/2012,1,0,1
2/6/2012,2/6/2012,2/7/2012,1,0,1
2/6/2012,2/6/2012,2/7/2012,1,0,1
4/30/2012,4/30/2012,5/2/2012,2,0,2
4/30/2012,4/30/2012,5/2/2012,2,0,2
5/4/2012,5/4/2012,5/11/2012,7,0,7
5/3/2012,4/30/2012,5/10/2012,10,-3,7
5/4/2012,5/3/2012,8/6/2012,95,-1,94
5/4/2012,5/4/2012,5/7/2012,3,0,3
5/4/2012,5/4/2012,5/7/2012,3,0,3
5/4/2012,5/4/2012,5/7/2012,3,0,3
5/9/2012,5/4/2012,5/16/2012,12,-5,7
5/9/2012,5/4/2012,5/16/2012,12,-5,7
5/9/2012,5/4/2012,5/16/2012,12,-5,7
5/29/2012,5/29/2012,5/30/2012,1,0,1
5/29/2012,5/29/2012,5/30/2012,1,0,1
5/30/2012,5/30/2012,5/31/2012,1,0,1
5/31/2012,5/31/2012,6/7/2012,7,0,7
5/31/2012,5/31/2012,6/7/2012,7,0,7
5/31/2012,5/31/2012,6/1/2012,1,0,1
6/6/2012,6/1/2012,6/13/2012,12,-5,7
6/4/2012,6/4/2012,6/5/2012,1,0,1
5/11/2012,5/11/2012,5/18/2012,7,0,7
5/11/2012,5/11/2012,5/14/2012,3,0,3
5/11/2012,5/11/2012,6/11/2012,31,0,31
5/11/2012,5/11/2012,5/14/2012,3,0,3
5/11/2012,5/11/2012,5/14/2012,3,0,3
6/13/2012,6/13/2012,6/20/2012,7,0,7
7/6/2012,7/6/2012,7/9/2012,3,0,3
6/15/2012,6/15/2012,7/31/2012,46,0,46
6/15/2012,6/15/2012,6/18/2012,3,0,3
6/15/2012,6/15/2012,6/18/2012,3,0,3
6/15/2012,6/15/2012,6/18/2012,3,0,3
7/10/2012,7/6/2012,7/17/2012,11,-4,7
7/10/2012,7/6/2012,7/17/2012,11,-4,7
7/6/2012,7/6/2012,7/12/2012,6,0,6
8/6/2012,8/6/2012,8/7/2012,1,0,1
8/6/2012,8/6/2012,8/7/2012,1,0,1
8/6/2012,8/6/2012,8/27/2012,21,0,21
8/6/2012,8/6/2012,8/27/2012,21,0,21
8/9/2012,8/7/2012,8/16/2012,9,-2,7
8/7/2012,8/7/2012,8/8/2012,1,0,1
8/7/2012,8/7/2012,8/8/2012,1,0,1
8/7/2012,8/7/2012,8/8/2012,1,0,1
8/10/2012,8/8/2012,8/17/2012,9,-2,7
8/10/2012,8/10/2012,8/13/2012,3,0,3
8/10/2012,8/10/2012,8/13/2012,3,0,3
8/16/2012,8/16/2012,8/23/2012,7,0,7
8/16/2012,8/16/2012,8/17/2012,1,0,1
8/17/2012,8/17/2012,8/20/2012,3,0,3
8/17/2012,8/17/2012,8/20/2012,3,0,3
8/17/2012,8/17/2012,8/20/2012,3,0,3
8/27/2012,8/27/2012,9/17/2012,21,0,21
8/27/2012,8/27/2012,8/28/2012,1,0,1
8/30/2012,8/30/2012,8/31/2012,1,0,1
8/28/2012,8/28/2012,9/4/2012,7,0,7
8/28/2012,8/28/2012,9/4/2012,7,0,7
8/28/2012,8/28/2012,9/4/2012,7,0,7
8/28/2012,8/28/2012,8/29/2012,1,0,1
8/30/2012,8/30/2012,8/31/2012,1,0,1
12/9/2011,12/9/2011,12/12/2011,3,0,3
12/9/2011,12/9/2011,12/12/2011,3,0,3
12/9/2011,12/9/2011,12/12/2011,3,0,3
12/9/2011,12/9/2011,12/12/2011,3,0,3
1/5/2012,1/3/2012,1/12/2012,9,-2,7
1/4/2012,1/4/2012,1/5/2012,1,0,1
1/5/2012,1/5/2012,1/6/2012,1,0,1
1/5/2012,1/5/2012,1/6/2012,1,0,1
1/5/2012,1/5/2012,1/6/2012,1,0,1
1/5/2012,1/5/2012,1/6/2012,1,0,1
1/5/2012,1/5/2012,1/6/2012,1,0,1
2/21/2012,2/21/2012,2/22/2012,1,0,1
6/5/2012,6/5/2012,6/6/2012,1,0,1
6/6/2012,6/6/2012,6/7/2012,1,0,1
6/6/2012,6/6/2012,6/28/2012,22,0,22
9/4/2012,9/4/2012,9/11/2012,7,0,7
6/6/2012,6/6/2012,6/7/2012,1,0,1
6/7/2012,6/7/2012,6/8/2012,1,0,1
6/7/2012,6/7/2012,6/8/2012,1,0,1
6/7/2012,6/7/2012,6/8/2012,1,0,1
9/6/2012,9/4/2012,9/13/2012,9,-2,7
9/7/2012,9/5/2012,9/14/2012,9,-2,7
9/5/2012,9/5/2012,9/27/2012,22,0,22
9/5/2012,9/5/2012,9/27/2012,22,0,22
9/5/2012,9/5/2012,9/6/2012,1,0,1
9/5/2012,9/5/2012,9/6/2012,1,0,1
9/5/2012,9/5/2012,9/12/2012,7,0,7
9/6/2012,9/6/2012,9/27/2012,21,0,21
9/6/2012,9/6/2012,9/13/2012,7,0,7
9/6/2012,9/6/2012,9/13/2012,7,0,7
9/6/2012,9/6/2012,9/13/2012,7,0,7
9/6/2012,9/6/2012,9/7/2012,1,0,1
9/7/2012,9/7/2012,9/14/2012,7,0,7
9/7/2012,9/7/2012,9/10/2012,3,0,3
9/7/2012,9/7/2012,9/11/2012,4,0,4
9/7/2012,9/7/2012,9/10/2012,3,0,3
12/12/2011,12/12/2011,12/19/2011,7,0,7
12/13/2011,12/13/2011,12/19/2011,6,0,6
12/13/2011,12/13/2011,12/14/2011,1,0,1
12/13/2011,12/13/2011,12/14/2011,1,0,1
12/15/2011,12/15/2011,12/16/2011,1,0,1
12/14/2011,12/14/2011,12/15/2011,1,0,1
12/15/2011,12/15/2011,12/16/2011,1,0,1
12/15/2011,12/15/2011,12/16/2011,1,0,1
12/19/2011,12/16/2011,12/27/2011,11,-3,8
12/16/2011,12/16/2011,12/19/2011,3,0,3
1/25/2012,1/23/2012,2/1/2012,9,-2,7
1/24/2012,1/24/2012,1/31/2012,7,0,7
1/25/2012,1/25/2012,1/26/2012,1,0,1
1/25/2012,1/25/2012,1/26/2012,1,0,1
1/25/2012,1/25/2012,2/2/2012,8,0,8
1/26/2012,1/26/2012,1/27/2012,1,0,1
1/31/2012,1/27/2012,2/29/2012,33,-4,29
4/24/2012,4/24/2012,4/27/2012,3,0,3
4/24/2012,4/24/2012,4/25/2012,1,0,1
4/24/2012,4/24/2012,4/25/2012,1,0,1
4/24/2012,4/24/2012,4/25/2012,1,0,1
4/26/2012,4/26/2012,5/3/2012,7,0,7
4/26/2012,4/26/2012,5/3/2012,7,0,7
4/26/2012,4/26/2012,5/3/2012,7,0,7
4/26/2012,4/26/2012,5/3/2012,7,0,7
4/26/2012,4/26/2012,5/3/2012,7,0,7
4/26/2012,4/26/2012,4/27/2012,1,0,1
4/27/2012,4/26/2012,6/27/2012,62,-1,61
4/27/2012,4/27/2012,4/30/2012,3,0,3
9/4/2012,8/31/2012,9/11/2012,11,-4,7
12/12/2011,12/12/2011,12/16/2011,4,0,4
5/9/2012,5/9/2012,5/16/2012,7,0,7
5/9/2012,5/9/2012,5/10/2012,1,0,1
5/14/2012,5/14/2012,5/15/2012,1,0,1
5/14/2012,5/14/2012,5/15/2012,1,0,1
5/14/2012,5/14/2012,5/15/2012,1,0,1
5/14/2012,5/14/2012,5/15/2012,1,0,1
5/16/2012,5/16/2012,5/17/2012,1,0,1
5/17/2012,5/17/2012,5/24/2012,7,0,7
5/17/2012,5/17/2012,5/24/2012,7,0,7
5/17/2012,5/17/2012,5/18/2012,1,0,1
5/17/2012,5/17/2012,5/18/2012,1,0,1
6/13/2012,6/13/2012,6/14/2012,1,0,1
6/13/2012,6/13/2012,6/14/2012,1,0,1
9/17/2012,9/17/2012,9/18/2012,1,0,1
9/17/2012,9/17/2012,10/15/2012,28,0,28
9/18/2012,9/18/2012,9/25/2012,7,0,7
9/18/2012,9/18/2012,9/25/2012,7,0,7
9/18/2012,9/18/2012,9/25/2012,7,0,7
9/18/2012,9/18/2012,9/19/2012,1,0,1
9/19/2012,9/19/2012,10/19/2012,30,0,30
9/19/2012,9/19/2012,9/20/2012,1,0,1
9/19/2012,9/19/2012,9/26/2012,7,0,7
9/20/2012,9/20/2012,9/21/2012,1,0,1
9/21/2012,9/21/2012,10/19/2012,28,0,28
9/21/2012,9/21/2012,9/24/2012,3,0,3
9/21/2012,9/21/2012,9/24/2012,3,0,3
9/21/2012,9/21/2012,9/28/2012,7,0,7
9/21/2012,9/21/2012,9/28/2012,7,0,7
11/7/2011,12/9/2011,12/12/2011,3,32,35
12/12/2011,12/9/2011,2/7/2012,60,-3,57
1/9/2012,1/9/2012,1/10/2012,1,0,1
1/9/2012,1/9/2012,1/26/2012,17,0,17
1/9/2012,1/9/2012,1/10/2012,1,0,1
1/10/2012,1/10/2012,1/17/2012,7,0,7
1/9/2012,1/9/2012,1/10/2012,1,0,1
1/9/2012,1/9/2012,1/10/2012,1,0,1
1/9/2012,1/9/2012,1/10/2012,1,0,1
1/9/2012,1/9/2012,1/10/2012,1,0,1
1/9/2012,1/9/2012,1/10/2012,1,0,1
1/12/2012,1/10/2012,1/19/2012,9,-2,7
1/10/2012,1/10/2012,1/11/2012,1,0,1
1/10/2012,1/10/2012,1/11/2012,1,0,1
1/11/2012,1/11/2012,4/11/2012,91,0,91
1/11/2012,1/11/2012,1/12/2012,1,0,1
1/16/2012,1/12/2012,4/16/2012,95,-4,91
1/16/2012,1/12/2012,1/17/2012,5,-4,1
1/12/2012,1/12/2012,1/13/2012,1,0,1
1/12/2012,1/12/2012,1/13/2012,1,0,1
1/13/2012,1/13/2012,1/19/2012,6,0,6
1/13/2012,1/13/2012,1/25/2012,12,0,12
3/5/2012,3/5/2012,3/6/2012,1,0,1
3/6/2012,3/5/2012,3/29/2012,24,-1,23
3/6/2012,3/5/2012,3/29/2012,24,-1,23
3/6/2012,3/5/2012,3/7/2012,2,-1,1
3/6/2012,3/5/2012,3/7/2012,2,-1,1
3/6/2012,3/5/2012,3/13/2012,8,-1,7
3/6/2012,3/5/2012,3/26/2012,21,-1,20
3/6/2012,3/6/2012,3/7/2012,1,0,1
3/6/2012,3/6/2012,3/7/2012,1,0,1
3/7/2012,3/7/2012,3/14/2012,7,0,7
3/7/2012,3/7/2012,3/14/2012,7,0,7
3/7/2012,3/7/2012,3/8/2012,1,0,1
3/7/2012,3/7/2012,3/8/2012,1,0,1
3/8/2012,3/8/2012,3/9/2012,1,0,1
3/8/2012,3/8/2012,3/9/2012,1,0,1
3/12/2012,3/9/2012,3/19/2012,10,-3,7
3/9/2012,3/9/2012,3/16/2012,7,0,7
3/9/2012,3/9/2012,3/16/2012,7,0,7
4/10/2012,4/10/2012,4/11/2012,1,0,1
1/16/2012,1/16/2012,1/17/2012,1,0,1
1/17/2012,1/17/2012,1/18/2012,1,0,1
1/17/2012,1/17/2012,1/24/2012,7,0,7
1/17/2012,1/17/2012,1/24/2012,7,0,7
7/17/2012,7/17/2012,7/18/2012,1,0,1
7/17/2012,7/17/2012,7/18/2012,1,0,1
7/17/2012,7/17/2012,7/18/2012,1,0,1
7/18/2012,7/17/2012,7/26/2012,9,-1,8
7/19/2012,7/17/2012,7/26/2012,9,-2,7
7/18/2012,7/18/2012,7/19/2012,1,0,1
7/18/2012,7/18/2012,7/19/2012,1,0,1
7/18/2012,7/18/2012,7/19/2012,1,0,1
7/20/2012,7/18/2012,7/27/2012,9,-2,7
7/20/2012,7/20/2012,7/23/2012,3,0,3
7/20/2012,7/20/2012,7/23/2012,3,0,3
7/20/2012,7/20/2012,7/27/2012,7,0,7
12/27/2011,12/27/2011,12/28/2011,1,0,1
12/27/2011,12/27/2011,12/28/2011,1,0,1
12/28/2011,12/28/2011,1/4/2012,7,0,7
12/28/2011,12/28/2011,1/30/2012,33,0,33
12/28/2011,12/28/2011,12/29/2011,1,0,1
12/28/2011,12/28/2011,12/29/2011,1,0,1
12/28/2011,12/28/2011,12/29/2011,1,0,1
12/28/2011,12/28/2011,12/29/2011,1,0,1
12/28/2011,12/28/2011,12/29/2011,1,0,1
12/28/2011,12/28/2011,12/29/2011,1,0,1
12/29/2011,12/29/2011,1/5/2012,7,0,7
12/29/2011,12/29/2011,12/30/2011,1,0,1
1/3/2012,12/30/2011,1/10/2012,11,-4,7
12/29/2011,12/29/2011,12/30/2011,1,0,1
12/30/2011,12/30/2011,1/3/2012,4,0,4
12/30/2011,12/30/2011,1/2/2012,3,0,3
2/24/2012,2/22/2012,3/2/2012,9,-2,7
2/23/2012,2/23/2012,3/1/2012,7,0,7
2/23/2012,2/23/2012,3/1/2012,7,0,7
2/23/2012,2/23/2012,3/1/2012,7,0,7
2/23/2012,2/23/2012,2/29/2012,6,0,6
2/23/2012,2/23/2012,2/24/2012,1,0,1
2/23/2012,2/23/2012,2/24/2012,1,0,1
3/28/2012,3/28/2012,3/29/2012,1,0,1
3/28/2012,3/28/2012,4/4/2012,7,0,7
3/29/2012,3/28/2012,4/5/2012,8,-1,7
3/29/2012,3/28/2012,4/5/2012,8,-1,7
3/28/2012,3/28/2012,3/30/2012,2,0,2
4/2/2012,3/29/2012,4/10/2012,12,-4,8
4/12/2012,4/11/2012,4/19/2012,8,-1,7
4/12/2012,4/11/2012,6/12/2012,62,-1,61
4/11/2012,4/11/2012,4/12/2012,1,0,1
4/13/2012,4/13/2012,4/16/2012,3,0,3
7/23/2012,7/23/2012,7/24/2012,1,0,1
7/23/2012,7/23/2012,7/24/2012,1,0,1
7/24/2012,7/24/2012,7/25/2012,1,0,1
7/24/2012,7/24/2012,7/25/2012,1,0,1
7/24/2012,7/24/2012,7/25/2012,1,0,1
7/25/2012,7/25/2012,7/26/2012,1,0,1
9/13/2012,9/13/2012,9/14/2012,1,0,1
9/13/2012,9/13/2012,9/14/2012,1,0,1
9/13/2012,9/13/2012,9/14/2012,1,0,1
9/14/2012,9/14/2012,9/21/2012,7,0,7
9/14/2012,9/14/2012,9/17/2012,3,0,3
9/14/2012,9/14/2012,9/17/2012,3,0,3
9/14/2012,9/14/2012,9/28/2012,14,0,14
9/18/2012,9/14/2012,9/25/2012,11,-4,7
12/12/2011,12/12/2011,12/13/2011,1,0,1
12/12/2011,12/12/2011,12/13/2011,1,0,1
12/14/2011,12/14/2011,1/16/2012,33,0,33
12/14/2011,12/14/2011,1/16/2012,33,0,33
12/14/2011,12/14/2011,12/15/2011,1,0,1
12/14/2011,12/14/2011,12/15/2011,1,0,1
12/15/2011,12/15/2011,12/16/2011,1,0,1
12/15/2011,12/15/2011,12/16/2011,1,0,1
12/16/2011,12/16/2011,12/19/2011,3,0,3
2/15/2012,2/15/2012,2/22/2012,7,0,7
2/15/2012,2/15/2012,2/16/2012,1,0,1
2/15/2012,2/15/2012,2/22/2012,7,0,7
2/15/2012,2/15/2012,2/27/2012,12,0,12
2/15/2012,2/15/2012,2/16/2012,1,0,1
2/15/2012,2/15/2012,2/16/2012,1,0,1
2/16/2012,2/16/2012,2/17/2012,1,0,1
2/21/2012,2/17/2012,2/24/2012,7,-4,3
2/21/2012,2/17/2012,2/28/2012,11,-4,7
7/26/2012,7/25/2012,8/10/2012,16,-1,15
7/26/2012,7/25/2012,8/2/2012,8,-1,7
7/25/2012,7/25/2012,8/2/2012,8,0,8
7/25/2012,7/25/2012,8/23/2012,29,0,29
8/8/2012,8/8/2012,8/9/2012,1,0,1
8/8/2012,8/8/2012,8/9/2012,1,0,1
8/8/2012,8/8/2012,8/9/2012,1,0,1
8/9/2012,8/9/2012,8/16/2012,7,0,7
8/9/2012,8/9/2012,8/16/2012,7,0,7
8/9/2012,8/9/2012,8/16/2012,7,0,7
8/9/2012,8/9/2012,8/10/2012,1,0,1
8/9/2012,8/9/2012,8/10/2012,1,0,1
1/11/2012,1/11/2012,1/12/2012,1,0,1
1/11/2012,1/11/2012,1/12/2012,1,0,1
1/11/2012,1/11/2012,1/12/2012,1,0,1
1/13/2012,1/12/2012,4/13/2012,92,-1,91
1/13/2012,1/13/2012,1/17/2012,4,0,4
1/13/2012,1/13/2012,1/17/2012,4,0,4
1/13/2012,1/13/2012,1/20/2012,7,0,7
1/13/2012,1/13/2012,1/20/2012,7,0,7
1/13/2012,1/13/2012,1/17/2012,4,0,4
4/26/2012,4/25/2012,5/3/2012,8,-1,7
4/30/2012,4/26/2012,5/30/2012,34,-4,30
4/30/2012,4/26/2012,5/7/2012,11,-4,7
4/26/2012,4/26/2012,4/27/2012,1,0,1
4/26/2012,4/26/2012,4/27/2012,1,0,1
6/25/2012,6/25/2012,6/29/2012,4,0,4
6/25/2012,6/25/2012,6/26/2012,1,0,1
6/25/2012,6/25/2012,6/26/2012,1,0,1
6/25/2012,6/25/2012,6/26/2012,1,0,1
6/25/2012,6/25/2012,7/16/2012,21,0,21
6/26/2012,6/26/2012,7/16/2012,20,0,20
6/26/2012,6/26/2012,6/27/2012,1,0,1
6/26/2012,6/26/2012,6/27/2012,1,0,1
7/3/2012,7/2/2012,7/10/2012,8,-1,7
6/29/2012,6/29/2012,8/2/2012,34,0,34
7/6/2012,7/4/2012,7/13/2012,9,-2,7
7/5/2012,7/5/2012,7/12/2012,7,0,7
4/11/2012,4/5/2012,4/18/2012,13,-6,7
4/16/2012,4/12/2012,8/16/2012,126,-4,122
4/16/2012,4/12/2012,8/16/2012,126,-4,122
8/9/2012,8/9/2012,8/15/2012,6,0,6
8/10/2012,8/10/2012,9/12/2012,33,0,33
8/10/2012,8/10/2012,8/17/2012,7,0,7
8/14/2012,8/10/2012,11/14/2012,96,-4,92
8/14/2012,8/10/2012,8/21/2012,11,-4,7
8/21/2012,8/21/2012,8/28/2012,7,0,7
8/24/2012,8/22/2012,9/24/2012,33,-2,31
8/22/2012,8/22/2012,8/23/2012,1,0,1
8/22/2012,8/22/2012,8/23/2012,1,0,1
8/22/2012,8/22/2012,8/23/2012,1,0,1
8/23/2012,8/23/2012,8/30/2012,7,0,7
8/23/2012,8/23/2012,8/30/2012,7,0,7
8/27/2012,8/23/2012,11/27/2012,96,-4,92
9/10/2012,9/10/2012,9/11/2012,1,0,1
9/13/2012,9/11/2012,11/13/2012,63,-2,61
9/13/2012,9/11/2012,9/20/2012,9,-2,7
4/13/2012,4/13/2012,4/16/2012,3,0,3
4/13/2012,4/13/2012,4/16/2012,3,0,3
4/13/2012,4/13/2012,4/16/2012,3,0,3
4/17/2012,4/13/2012,4/24/2012,11,-4,7
4/1/2015,4/1/2015,5/4/2015,33,0,33
4/9/2015,4/7/2015,5/11/2015,34,-2,32
4/9/2015,4/7/2015,5/11/2015,34,-2,32
4/9/2015,4/7/2015,6/9/2015,63,-2,61
4/17/2015,4/17/2015,6/10/2015,54,0,54
4/17/2015,4/17/2015,4/24/2015,7,0,7
4/17/2015,4/17/2015,4/24/2015,7,0,7
4/23/2015,4/21/2015,5/26/2015,35,-2,33
12/17/2015,12/17/2015,12/24/2015,7,0,7
12/17/2015,12/17/2015,12/24/2015,7,0,7
12/17/2015,12/17/2015,12/24/2015,7,0,7
12/18/2015,12/18/2015,12/28/2015,10,0,10
12/23/2015,12/21/2015,2/23/2016,64,-2,62
12/21/2015,12/21/2015,12/29/2015,8,0,8
12/24/2015,12/22/2015,1/25/2016,34,-2,32
12/23/2015,12/23/2015,12/30/2015,7,0,7
12/28/2015,12/23/2015,3/29/2016,97,-5,92
12/29/2015,12/23/2015,2/1/2016,40,-6,34
12/23/2015,12/23/2015,12/30/2015,7,0,7
12/23/2015,12/23/2015,12/30/2015,7,0,7
5/6/2016,5/6/2016,8/5/2016,91,0,91
5/6/2016,5/6/2016,8/8/2016,94,0,94
5/6/2016,5/6/2016,5/13/2016,7,0,7
5/6/2016,5/6/2016,5/13/2016,7,0,7
5/6/2016,5/6/2016,6/6/2016,31,0,31
3/6/2017,3/6/2017,6/8/2017,94,0,94
3/6/2017,3/6/2017,6/6/2017,92,0,92
3/7/2017,3/7/2017,3/14/2017,7,0,7
3/8/2017,3/7/2017,5/9/2017,63,-1,62
3/8/2017,3/7/2017,4/10/2017,34,-1,33
4/20/2017,4/18/2017,5/22/2017,34,-2,32
8/7/2017,8/7/2017,8/14/2017,7,0,7
8/7/2017,8/7/2017,8/16/2017,9,0,9
10/12/2015,10/8/2015,12/14/2015,67,-4,63
10/12/2015,10/8/2015,11/12/2015,35,-4,31
10/12/2015,10/8/2015,11/12/2015,35,-4,31
10/12/2015,10/8/2015,11/12/2015,35,-4,31
10/9/2015,10/9/2015,10/16/2015,7,0,7
10/9/2015,10/9/2015,10/16/2015,7,0,7
10/9/2015,10/9/2015,10/16/2015,7,0,7
10/9/2015,10/9/2015,10/16/2015,7,0,7
10/13/2015,10/13/2015,10/20/2015,7,0,7
10/13/2015,10/13/2015,11/13/2015,31,0,31
10/14/2015,10/14/2015,10/21/2015,7,0,7
10/19/2015,10/15/2015,11/19/2015,35,-4,31
10/19/2015,10/15/2015,11/19/2015,35,-4,31
10/16/2015,10/16/2015,11/19/2015,34,0,34
10/23/2015,10/19/2015,10/30/2015,11,-4,7
10/21/2015,10/19/2015,11/23/2015,35,-2,33
10/21/2015,10/19/2015,11/23/2015,35,-2,33
10/21/2015,10/19/2015,10/28/2015,9,-2,7
10/20/2015,10/20/2015,1/20/2016,92,0,92
5/12/2016,5/11/2016,8/12/2016,93,-1,92
5/17/2016,5/13/2016,6/17/2016,35,-4,31
5/13/2016,5/13/2016,5/20/2016,7,0,7
5/13/2016,5/13/2016,5/20/2016,7,0,7
5/13/2016,5/13/2016,5/23/2016,10,0,10
11/28/2016,11/28/2016,12/12/2016,14,0,14
11/28/2016,11/28/2016,12/6/2016,8,0,8
11/29/2016,11/28/2016,12/6/2016,8,-1,7
8/14/2017,8/14/2017,9/14/2017,31,0,31
8/16/2017,8/14/2017,9/13/2017,30,-2,28
8/17/2017,8/17/2017,8/24/2017,7,0,7
8/17/2017,8/17/2017,8/24/2017,7,0,7
8/22/2016,8/18/2016,9/22/2016,35,-4,31
8/22/2016,8/18/2016,9/22/2016,35,-4,31
8/22/2016,8/18/2016,10/24/2016,67,-4,63
8/18/2016,8/18/2016,9/19/2016,32,0,32
8/18/2016,8/18/2016,9/19/2016,32,0,32
8/18/2016,8/18/2016,8/25/2016,7,0,7
8/18/2016,8/18/2016,11/17/2016,91,0,91
8/18/2016,8/18/2016,11/17/2016,91,0,91
8/19/2016,8/19/2016,11/18/2016,91,0,91
8/31/2016,8/26/2016,9/30/2016,35,-5,30
9/1/2016,9/1/2016,9/30/2016,29,0,29
9/1/2016,9/1/2016,9/8/2016,7,0,7
9/1/2016,9/1/2016,9/8/2016,7,0,7
11/10/2016,11/10/2016,11/17/2016,7,0,7
11/10/2016,11/10/2016,11/17/2016,7,0,7
11/10/2016,11/10/2016,11/17/2016,7,0,7
11/10/2016,11/10/2016,2/13/2017,95,0,95
3/1/2017,3/1/2017,3/8/2017,7,0,7
3/1/2017,3/1/2017,3/8/2017,7,0,7
3/1/2017,3/1/2017,3/8/2017,7,0,7
3/21/2017,3/21/2017,3/29/2017,8,0,8
3/21/2017,3/21/2017,3/29/2017,8,0,8
4/10/2017,4/6/2017,4/18/2017,12,-4,8
4/6/2017,4/6/2017,7/3/2017,88,0,88
4/6/2017,4/6/2017,10/3/2017,180,0,180
4/6/2017,4/6/2017,4/28/2017,22,0,22
4/6/2017,4/6/2017,7/7/2017,92,0,92
4/6/2017,4/6/2017,7/7/2017,92,0,92
4/6/2017,4/6/2017,4/13/2017,7,0,7
4/17/2017,4/12/2017,4/25/2017,13,-5,8
4/18/2017,4/18/2017,4/25/2017,7,0,7
4/18/2017,4/18/2017,4/25/2017,7,0,7
2/18/2016,2/18/2016,2/25/2016,7,0,7
2/23/2016,2/22/2016,3/2/2016,9,-1,8
2/24/2016,2/23/2016,3/29/2016,35,-1,34
2/24/2016,2/23/2016,3/29/2016,35,-1,34
2/23/2016,2/23/2016,3/1/2016,7,0,7
2/23/2016,2/23/2016,3/2/2016,8,0,8
2/25/2016,2/25/2016,3/3/2016,7,0,7
4/11/2016,4/7/2016,6/10/2016,64,-4,60
4/11/2016,4/7/2016,6/13/2016,67,-4,63
4/7/2016,4/7/2016,7/7/2016,91,0,91
4/8/2016,4/8/2016,4/15/2016,7,0,7
4/8/2016,4/8/2016,4/15/2016,7,0,7
9/2/2015,9/2/2015,9/9/2015,7,0,7
9/2/2015,9/2/2015,9/28/2015,26,0,26
9/2/2015,9/2/2015,9/3/2015,1,0,1
9/7/2015,9/3/2015,10/7/2015,34,-4,30
9/7/2015,9/3/2015,10/7/2015,34,-4,30
9/4/2015,9/4/2015,9/11/2015,7,0,7
2/1/2016,2/1/2016,5/2/2016,91,0,91
2/3/2016,2/1/2016,5/6/2016,95,-2,93
2/3/2016,2/2/2016,5/6/2016,94,-1,93
2/3/2016,2/2/2016,5/6/2016,94,-1,93
2/5/2016,2/5/2016,5/6/2016,91,0,91
2/5/2016,2/5/2016,5/12/2016,97,0,97
2/8/2016,2/8/2016,5/9/2016,91,0,91
2/9/2016,2/9/2016,5/9/2016,90,0,90
2/9/2016,2/9/2016,2/16/2016,7,0,7
2/15/2016,2/11/2016,3/15/2016,33,-4,29
2/15/2016,2/11/2016,3/15/2016,33,-4,29
10/17/2016,10/13/2016,11/17/2016,35,-4,31
10/17/2016,10/13/2016,11/16/2016,34,-4,30
10/17/2016,10/14/2016,11/17/2016,34,-3,31
3/8/2017,3/8/2017,3/15/2017,7,0,7
3/8/2017,3/8/2017,3/15/2017,7,0,7
3/13/2017,3/9/2017,4/13/2017,35,-4,31
3/13/2017,3/9/2017,4/13/2017,35,-4,31
3/13/2017,3/9/2017,6/13/2017,96,-4,92
3/10/2017,3/10/2017,4/10/2017,31,0,31
3/10/2017,3/10/2017,3/17/2017,7,0,7
3/10/2017,3/10/2017,3/17/2017,7,0,7
4/18/2017,4/18/2017,7/18/2017,91,0,91
4/18/2017,4/18/2017,7/18/2017,91,0,91
4/19/2017,4/19/2017,7/19/2017,91,0,91
4/19/2017,4/19/2017,7/19/2017,91,0,91
4/19/2017,4/19/2017,4/26/2017,7,0,7
4/20/2017,4/20/2017,4/27/2017,7,0,7
4/21/2017,4/21/2017,5/22/2017,31,0,31
4/24/2017,4/24/2017,7/24/2017,91,0,91
4/25/2017,4/25/2017,5/2/2017,7,0,7
4/25/2017,4/25/2017,5/2/2017,7,0,7
5/2/2017,4/28/2017,8/2/2017,96,-4,92
5/2/2017,4/28/2017,8/2/2017,96,-4,92
5/2/2017,4/28/2017,5/9/2017,11,-4,7
4/28/2017,4/28/2017,5/5/2017,7,0,7
5/5/2017,5/5/2017,8/8/2017,95,0,95
5/5/2017,5/5/2017,8/2/2017,89,0,89
5/9/2017,5/9/2017,8/9/2017,92,0,92
5/11/2017,5/9/2017,6/12/2017,34,-2,32
10/26/2017,10/26/2017,10/31/2017,5,0,5
10/20/2015,10/20/2015,10/27/2015,7,0,7
10/20/2015,10/20/2015,10/27/2015,7,0,7
3/10/2016,3/10/2016,3/17/2016,7,0,7
3/11/2016,3/10/2016,6/14/2016,96,-1,95
3/14/2016,3/11/2016,4/15/2016,35,-3,32
3/11/2016,3/11/2016,4/14/2016,34,0,34
4/26/2016,4/25/2016,5/4/2016,9,-1,8
4/25/2016,4/25/2016,5/2/2016,7,0,7
4/25/2016,4/25/2016,5/2/2016,7,0,7
4/25/2016,4/25/2016,5/2/2016,7,0,7
4/25/2016,4/25/2016,5/3/2016,8,0,8
4/25/2016,4/25/2016,4/26/2016,1,0,1
4/26/2016,4/26/2016,5/4/2016,8,0,8
5/9/2016,5/9/2016,8/9/2016,92,0,92
5/9/2016,5/9/2016,8/9/2016,92,0,92
5/9/2016,5/9/2016,5/16/2016,7,0,7
5/9/2016,5/9/2016,5/16/2016,7,0,7
5/10/2016,5/10/2016,8/10/2016,92,0,92
10/7/2016,10/7/2016,10/14/2016,7,0,7
1/5/2015,1/5/2015,3/6/2015,60,0,60
1/5/2015,1/5/2015,2/9/2015,35,0,35
1/5/2015,1/5/2015,3/27/2015,81,0,81
1/5/2015,1/5/2015,3/27/2015,81,0,81
1/6/2015,1/5/2015,1/6/2015,1,-1,0
1/6/2015,1/6/2015,1/13/2015,7,0,7
1/6/2015,1/6/2015,1/13/2015,7,0,7
1/6/2015,1/6/2015,2/6/2015,31,0,31
1/6/2015,1/6/2015,1/7/2015,1,0,1
1/7/2015,1/7/2015,2/13/2015,37,0,37
1/12/2015,1/8/2015,1/19/2015,11,-4,7
1/12/2015,1/8/2015,3/12/2015,63,-4,59
1/23/2015,1/22/2015,2/26/2015,35,-1,34
1/23/2015,1/23/2015,1/30/2015,7,0,7
1/28/2015,1/28/2015,2/27/2015,30,0,30
5/11/2015,5/6/2015,6/11/2015,36,-5,31
5/12/2015,5/7/2015,5/19/2015,12,-5,7
5/8/2015,5/8/2015,8/7/2015,91,0,91
5/13/2015,5/12/2015,6/15/2015,34,-1,33
5/13/2015,5/13/2015,5/20/2015,7,0,7
5/15/2015,5/15/2015,5/22/2015,7,0,7
5/18/2015,5/18/2015,5/26/2015,8,0,8
5/18/2015,5/18/2015,5/26/2015,8,0,8
5/26/2015,5/21/2015,6/26/2015,36,-5,31
5/26/2015,5/21/2015,6/26/2015,36,-5,31
5/26/2015,5/21/2015,6/1/2015,11,-5,6
4/3/2017,3/30/2017,5/3/2017,34,-4,30
3/31/2017,3/30/2017,4/10/2017,11,-1,10
3/30/2017,3/30/2017,4/28/2017,29,0,29
4/4/2017,3/30/2017,4/28/2017,29,-5,24
3/30/2017,3/30/2017,4/28/2017,29,0,29
3/30/2017,3/30/2017,4/28/2017,29,0,29
3/30/2017,3/30/2017,4/28/2017,29,0,29
3/31/2017,3/31/2017,5/31/2017,61,0,61
4/4/2017,3/31/2017,4/10/2017,10,-4,6
4/4/2017,3/31/2017,4/7/2017,7,-4,3
6/19/2017,6/15/2017,7/19/2017,34,-4,30
6/19/2017,6/15/2017,6/26/2017,11,-4,7
6/16/2017,6/16/2017,9/18/2017,94,0,94
6/16/2017,6/16/2017,9/18/2017,94,0,94
6/16/2017,6/16/2017,6/23/2017,7,0,7
6/26/2017,6/26/2017,7/3/2017,7,0,7
6/27/2017,6/27/2017,9/27/2017,92,0,92
3/18/2016,3/16/2016,4/18/2016,33,-2,31
3/17/2016,3/17/2016,3/24/2016,7,0,7
3/17/2016,3/17/2016,3/24/2016,7,0,7
4/12/2016,4/8/2016,5/12/2016,34,-4,30
5/3/2016,5/3/2016,5/10/2016,7,0,7
5/17/2016,5/3/2016,5/10/2016,7,-14,-7
5/3/2016,5/3/2016,5/10/2016,7,0,7
5/17/2016,5/3/2016,8/2/2016,91,-14,77
11/16/2016,11/16/2016,11/23/2016,7,0,7
11/16/2016,11/16/2016,11/23/2016,7,0,7
11/16/2016,11/16/2016,11/22/2016,6,0,6
11/17/2016,11/16/2016,1/6/2017,51,-1,50
11/17/2016,11/17/2016,2/16/2017,91,0,91
11/17/2016,11/17/2016,2/16/2017,91,0,91
11/17/2016,11/17/2016,11/23/2016,6,0,6
11/18/2016,11/18/2016,12/14/2016,26,0,26
11/18/2016,11/18/2016,12/14/2016,26,0,26
12/5/2016,12/5/2016,1/5/2017,31,0,31
1/13/2017,1/13/2017,2/13/2017,31,0,31
1/13/2017,1/13/2017,2/13/2017,31,0,31
1/13/2017,1/13/2017,2/13/2017,31,0,31
1/13/2017,1/13/2017,1/20/2017,7,0,7
4/4/2016,3/29/2016,4/5/2016,7,-6,1
4/6/2016,4/6/2016,4/13/2016,7,0,7
4/8/2016,4/6/2016,6/8/2016,63,-2,61
4/13/2016,4/12/2016,5/16/2016,34,-1,33
4/12/2016,4/12/2016,7/12/2016,91,0,91
4/12/2016,4/12/2016,4/19/2016,7,0,7
4/12/2016,4/12/2016,4/19/2016,7,0,7
5/25/2016,5/25/2016,6/1/2016,7,0,7
6/28/2016,6/27/2016,8/29/2016,63,-1,62
8/17/2016,8/16/2016,8/24/2016,8,-1,7
8/16/2016,8/16/2016,8/23/2016,7,0,7
8/22/2016,8/22/2016,9/22/2016,31,0,31
8/23/2016,8/23/2016,8/30/2016,7,0,7
8/25/2016,8/25/2016,9/26/2016,32,0,32
8/29/2016,8/25/2016,9/29/2016,35,-4,31
8/25/2016,8/25/2016,9/1/2016,7,0,7
8/30/2016,8/26/2016,9/7/2016,12,-4,8
9/19/2016,9/15/2016,10/19/2016,34,-4,30
9/15/2016,9/15/2016,10/19/2016,34,0,34
9/15/2016,9/15/2016,9/22/2016,7,0,7
9/15/2016,9/15/2016,9/22/2016,7,0,7
9/15/2016,9/15/2016,9/22/2016,7,0,7
9/16/2016,9/15/2016,12/14/2016,90,-1,89
9/16/2016,9/16/2016,9/23/2016,7,0,7
12/28/2016,12/28/2016,1/30/2017,33,0,33
12/28/2016,12/28/2016,2/28/2017,62,0,62
12/30/2016,12/28/2016,2/2/2017,36,-2,34
12/28/2016,12/28/2016,4/7/2017,100,0,100
12/28/2016,12/28/2016,4/7/2017,100,0,100
12/28/2016,12/28/2016,4/7/2017,100,0,100
12/28/2016,12/28/2016,4/7/2017,100,0,100
12/28/2016,12/28/2016,1/4/2017,7,0,7
12/28/2016,12/28/2016,1/4/2017,7,0,7
12/28/2016,12/28/2016,1/4/2017,7,0,7
12/29/2016,12/29/2016,1/31/2017,33,0,33
12/29/2016,12/29/2016,1/31/2017,33,0,33
12/29/2016,12/29/2016,1/31/2017,33,0,33
12/29/2016,12/29/2016,1/31/2017,33,0,33
12/29/2016,12/29/2016,1/30/2017,32,0,32
12/29/2016,12/29/2016,1/30/2017,32,0,32
12/30/2016,12/29/2016,2/28/2017,61,-1,60
1/11/2017,1/11/2017,4/11/2017,90,0,90
1/11/2017,1/11/2017,1/18/2017,7,0,7
1/11/2017,1/11/2017,1/18/2017,7,0,7
1/11/2017,1/11/2017,1/18/2017,7,0,7
1/11/2017,1/11/2017,1/18/2017,7,0,7
1/16/2017,1/12/2017,2/16/2017,35,-4,31
1/16/2017,1/12/2017,1/23/2017,11,-4,7
1/17/2017,1/12/2017,4/18/2017,96,-5,91
9/12/2016,9/12/2016,12/12/2016,91,0,91
9/12/2016,9/12/2016,12/12/2016,91,0,91
9/12/2016,9/12/2016,12/12/2016,91,0,91
9/14/2016,9/12/2016,12/14/2016,93,-2,91
9/13/2016,9/12/2016,12/13/2016,92,-1,91
9/21/2016,9/19/2016,12/21/2016,93,-2,91
9/20/2016,9/20/2016,9/27/2016,7,0,7
9/20/2016,9/20/2016,9/27/2016,7,0,7
2/21/2017,2/21/2017,3/1/2017,8,0,8
2/21/2017,2/21/2017,3/1/2017,8,0,8
2/21/2017,2/21/2017,3/1/2017,8,0,8
6/6/2017,6/6/2017,9/6/2017,92,0,92
6/14/2017,6/14/2017,9/14/2017,92,0,92
6/14/2017,6/14/2017,9/14/2017,92,0,92
6/14/2017,6/14/2017,9/14/2017,92,0,92
6/15/2017,6/15/2017,9/15/2017,92,0,92
6/15/2017,6/15/2017,9/15/2017,92,0,92
4/18/2016,4/14/2016,5/18/2016,34,-4,30
11/15/2016,11/14/2016,11/23/2016,9,-1,8
11/15/2016,11/14/2016,12/16/2016,32,-1,31
12/5/2016,11/14/2016,12/14/2016,30,-21,9
11/14/2016,11/14/2016,11/21/2016,7,0,7
11/14/2016,11/14/2016,11/21/2016,7,0,7
11/14/2016,11/14/2016,11/21/2016,7,0,7
11/17/2016,11/15/2016,12/19/2016,34,-2,32
11/17/2016,11/15/2016,12/19/2016,34,-2,32
7/12/2017,7/12/2017,8/14/2017,33,0,33
7/12/2017,7/12/2017,8/14/2017,33,0,33
7/17/2017,7/13/2017,7/24/2017,11,-4,7
7/17/2017,7/13/2017,8/17/2017,35,-4,31
2/15/2017,2/15/2017,2/22/2017,7,0,7
2/15/2017,2/15/2017,2/22/2017,7,0,7
2/20/2017,2/17/2017,4/20/2017,62,-3,59
2/20/2017,2/17/2017,4/20/2017,62,-3,59
2/20/2017,2/17/2017,3/20/2017,31,-3,28
2/20/2017,2/17/2017,3/20/2017,31,-3,28
2/20/2017,2/17/2017,2/27/2017,10,-3,7
2/17/2017,2/17/2017,2/24/2017,7,0,7
2/17/2017,2/17/2017,2/24/2017,7,0,7
6/23/2017,6/22/2017,7/24/2017,32,-1,31
6/26/2017,6/22/2017,7/26/2017,34,-4,30
6/23/2017,6/23/2017,6/30/2017,7,0,7
6/26/2017,6/23/2017,6/30/2017,7,-3,4
7/3/2017,7/3/2017,10/3/2017,92,0,92
7/3/2017,7/3/2017,7/10/2017,7,0,7
7/3/2017,7/3/2017,7/10/2017,7,0,7
10/26/2017,10/26/2017,10/31/2017,5,0,5
10/26/2017,10/26/2017,10/31/2017,5,0,5
6/22/2017,6/22/2017,7/24/2017,32,0,32
6/2/2015,6/2/2015,6/9/2015,7,0,7
6/2/2015,6/2/2015,6/9/2015,7,0,7
6/8/2015,6/5/2015,7/8/2015,33,-3,30
6/10/2015,6/8/2015,9/10/2015,94,-2,92
6/11/2015,6/9/2015,7/13/2015,34,-2,32
6/11/2015,6/9/2015,7/13/2015,34,-2,32
6/11/2015,6/9/2015,7/13/2015,34,-2,32
6/9/2015,6/9/2015,6/10/2015,1,0,1
6/9/2015,6/9/2015,6/16/2015,7,0,7
6/9/2015,6/9/2015,6/16/2015,7,0,7
6/9/2015,6/9/2015,6/23/2015,14,0,14
12/16/2015,12/16/2015,12/23/2015,7,0,7
12/16/2015,12/16/2015,12/17/2015,1,0,1
12/16/2015,12/16/2015,12/17/2015,1,0,1
12/16/2015,12/16/2015,12/17/2015,1,0,1
12/21/2015,12/17/2015,3/21/2016,95,-4,91
12/21/2015,12/17/2015,3/21/2016,95,-4,91
12/21/2015,12/17/2015,2/22/2016,67,-4,63
12/22/2015,12/22/2015,12/29/2015,7,0,7
12/28/2015,12/28/2015,2/29/2016,63,0,63
9/7/2017,9/7/2017,9/27/2017,20,0,20
12/23/2016,12/21/2016,3/23/2017,92,-2,90
12/22/2016,12/21/2016,3/23/2017,92,-1,91
12/21/2016,12/21/2016,1/3/2017,13,0,13
12/27/2016,12/22/2016,1/27/2017,36,-5,31
12/27/2016,12/22/2016,1/27/2017,36,-5,31
12/28/2016,12/23/2016,1/30/2017,38,-5,33
7/24/2017,7/20/2017,7/31/2017,11,-4,7
7/24/2017,7/20/2017,8/24/2017,35,-4,31
7/24/2017,7/20/2017,8/24/2017,35,-4,31
8/3/2017,8/3/2017,9/5/2017,33,0,33
8/4/2017,8/4/2017,8/11/2017,7,0,7
6/2/2017,6/2/2017,6/9/2017,7,0,7
6/6/2017,6/2/2017,7/5/2017,33,-4,29
10/27/2015,10/26/2015,11/30/2015,35,-1,34
11/4/2015,11/2/2015,11/11/2015,9,-2,7
11/4/2015,11/2/2015,12/4/2015,32,-2,30
8/31/2017,8/31/2017,9/1/2017,1,0,1
7/26/2016,7/26/2016,8/2/2016,7,0,7
7/26/2016,7/26/2016,8/2/2016,7,0,7
7/26/2016,7/26/2016,8/2/2016,7,0,7
8/3/2016,8/3/2016,11/3/2016,92,0,92
8/3/2016,8/3/2016,8/10/2016,7,0,7
8/5/2016,8/3/2016,10/7/2016,65,-2,63
8/4/2016,8/3/2016,11/4/2016,93,-1,92
8/4/2016,8/4/2016,11/4/2016,92,0,92
8/5/2016,8/5/2016,9/8/2016,34,0,34
9/30/2016,9/30/2016,11/4/2016,35,0,35
9/30/2016,9/30/2016,10/7/2016,7,0,7
9/30/2016,9/30/2016,10/7/2016,7,0,7
12/14/2016,12/14/2016,12/21/2016,7,0,7
12/16/2016,12/14/2016,1/16/2017,33,-2,31
5/2/2017,5/2/2017,5/5/2017,3,0,3
5/2/2017,5/2/2017,5/5/2017,3,0,3
5/2/2017,5/2/2017,8/2/2017,92,0,92
5/29/2017,5/29/2017,8/29/2017,92,0,92
5/31/2017,5/29/2017,6/30/2017,32,-2,30
5/31/2017,5/30/2017,6/30/2017,31,-1,30
5/30/2017,5/30/2017,6/30/2017,31,0,31
5/30/2017,5/30/2017,6/30/2017,31,0,31
5/30/2017,5/30/2017,6/30/2017,31,0,31
5/30/2017,5/30/2017,6/30/2017,31,0,31
5/30/2017,5/30/2017,6/30/2017,31,0,31
5/30/2017,5/30/2017,6/30/2017,31,0,31
7/17/2015,7/17/2015,7/24/2015,7,0,7
7/17/2015,7/17/2015,7/24/2015,7,0,7
7/17/2015,7/17/2015,7/20/2015,3,0,3
7/22/2015,7/20/2015,7/29/2015,9,-2,7
7/22/2015,7/22/2015,7/29/2015,7,0,7
7/22/2015,7/22/2015,7/29/2015,7,0,7
7/22/2015,7/22/2015,7/27/2015,5,0,5
7/24/2015,7/24/2015,9/24/2015,62,0,62
8/24/2015,8/24/2015,8/31/2015,7,0,7
2/16/2016,2/15/2016,2/24/2016,9,-1,8
8/16/2017,8/11/2017,10/16/2017,66,-5,61
3/27/2015,3/27/2015,4/2/2015,6,0,6
3/27/2015,3/27/2015,4/2/2015,6,0,6
3/27/2015,3/27/2015,4/2/2015,6,0,6
3/27/2015,3/27/2015,4/2/2015,6,0,6
3/30/2015,3/30/2015,6/30/2015,92,0,92
4/7/2015,4/1/2015,6/8/2015,68,-6,62
4/7/2015,4/1/2015,4/14/2015,13,-6,7
4/7/2015,4/1/2015,5/7/2015,36,-6,30
4/7/2015,4/1/2015,5/7/2015,36,-6,30
4/1/2015,4/1/2015,4/2/2015,1,0,1
4/9/2015,4/9/2015,5/11/2015,32,0,32
4/15/2015,4/15/2015,4/16/2015,1,0,1
4/17/2015,4/15/2015,5/18/2015,33,-2,31
4/16/2015,4/16/2015,5/18/2015,32,0,32
4/16/2015,4/16/2015,5/18/2015,32,0,32
4/29/2015,4/29/2015,5/7/2015,8,0,8
4/29/2015,4/29/2015,5/7/2015,8,0,8
5/5/2015,4/29/2015,5/12/2015,13,-6,7
5/4/2015,5/4/2015,6/4/2015,31,0,31
5/5/2015,5/5/2015,5/12/2015,7,0,7
5/5/2015,5/5/2015,6/5/2015,31,0,31
5/5/2015,5/5/2015,6/5/2015,31,0,31
5/5/2015,5/5/2015,5/11/2015,6,0,6
5/6/2015,5/6/2015,6/10/2015,35,0,35
5/7/2015,5/7/2015,6/8/2015,32,0,32
5/7/2015,5/7/2015,6/8/2015,32,0,32
5/7/2015,5/7/2015,5/13/2015,6,0,6
5/7/2015,5/7/2015,5/13/2015,6,0,6
5/12/2015,5/12/2015,5/19/2015,7,0,7
5/15/2015,5/13/2015,6/15/2015,33,-2,31
5/27/2015,5/22/2015,6/29/2015,38,-5,33
5/18/2016,5/16/2016,6/20/2016,35,-2,33
5/19/2016,5/17/2016,6/20/2016,34,-2,32
6/6/2016,6/6/2016,7/6/2016,30,0,30
6/6/2016,6/6/2016,7/6/2016,30,0,30
6/7/2016,6/7/2016,6/14/2016,7,0,7
6/7/2016,6/7/2016,6/14/2016,7,0,7
6/7/2016,6/7/2016,6/14/2016,7,0,7
6/7/2016,6/7/2016,9/7/2016,92,0,92
6/13/2016,6/13/2016,6/29/2016,16,0,16
7/27/2016,7/27/2016,8/3/2016,7,0,7
9/6/2016,9/5/2016,9/14/2016,9,-1,8
11/28/2016,11/28/2016,12/5/2016,7,0,7
11/28/2016,11/28/2016,12/5/2016,7,0,7
11/28/2016,11/28/2016,12/5/2016,7,0,7
12/27/2016,12/27/2016,3/27/2017,90,0,90
12/27/2016,12/27/2016,1/3/2017,7,0,7
12/27/2016,12/27/2016,1/3/2017,7,0,7
5/9/2017,5/9/2017,7/10/2017,62,0,62
5/10/2017,5/9/2017,6/12/2017,34,-1,33
5/10/2017,5/10/2017,6/12/2017,33,0,33
5/9/2017,5/9/2017,8/9/2017,92,0,92
5/9/2017,5/9/2017,8/9/2017,92,0,92
5/10/2017,5/10/2017,6/12/2017,33,0,33
5/10/2017,5/10/2017,6/12/2017,33,0,33
5/22/2017,5/22/2017,6/22/2017,31,0,31
5/22/2017,5/22/2017,7/24/2017,63,0,63
5/22/2017,5/22/2017,7/24/2017,63,0,63
5/23/2017,5/22/2017,8/24/2017,94,-1,93
5/23/2017,5/22/2017,6/26/2017,35,-1,34
5/26/2017,5/24/2017,6/29/2017,36,-2,34
1/8/2015,1/8/2015,2/6/2015,29,0,29
1/8/2015,1/8/2015,2/9/2015,32,0,32
1/16/2015,1/16/2015,1/23/2015,7,0,7
1/20/2015,1/20/2015,1/27/2015,7,0,7
1/20/2015,1/20/2015,1/27/2015,7,0,7
4/28/2015,4/24/2015,5/5/2015,11,-4,7
4/24/2015,4/24/2015,5/29/2015,35,0,35
8/1/2016,8/1/2016,8/8/2016,7,0,7
8/3/2016,8/3/2016,8/10/2016,7,0,7
8/5/2016,8/5/2016,8/12/2016,7,0,7
8/5/2016,8/5/2016,8/12/2016,7,0,7
8/9/2016,8/9/2016,8/16/2016,7,0,7
8/9/2016,8/9/2016,8/16/2016,7,0,7
8/9/2016,8/9/2016,11/9/2016,92,0,92
8/12/2016,8/9/2016,10/12/2016,64,-3,61
8/12/2016,8/9/2016,11/14/2016,97,-3,94
5/12/2016,5/12/2016,8/12/2016,92,0,92
5/12/2016,5/12/2016,5/19/2016,7,0,7
5/12/2016,5/12/2016,5/19/2016,7,0,7
5/12/2016,5/12/2016,8/11/2016,91,0,91
5/31/2016,5/31/2016,6/30/2016,30,0,30
5/31/2016,5/31/2016,6/7/2016,7,0,7
5/31/2016,5/31/2016,6/7/2016,7,0,7
5/31/2016,5/31/2016,6/7/2016,7,0,7
5/31/2016,5/31/2016,6/7/2016,7,0,7
7/15/2016,7/15/2016,7/22/2016,7,0,7
7/15/2016,7/15/2016,7/22/2016,7,0,7
8/10/2016,8/10/2016,10/10/2016,61,0,61
8/10/2016,8/10/2016,8/17/2016,7,0,7
8/10/2016,8/10/2016,8/17/2016,7,0,7
8/16/2016,8/11/2016,9/16/2016,36,-5,31
8/11/2016,8/11/2016,9/13/2016,33,0,33
8/18/2016,8/16/2016,9/19/2016,34,-2,32
8/18/2016,8/16/2016,9/19/2016,34,-2,32
10/27/2016,10/27/2016,11/3/2016,7,0,7
10/27/2016,10/27/2016,11/3/2016,7,0,7
11/2/2016,10/28/2016,2/2/2017,97,-5,92
11/2/2016,10/28/2016,1/2/2017,66,-5,61
10/28/2016,10/28/2016,11/4/2016,7,0,7
10/28/2016,10/28/2016,11/4/2016,7,0,7
10/28/2016,10/28/2016,11/4/2016,7,0,7
10/28/2016,10/28/2016,11/4/2016,7,0,7
10/28/2016,10/28/2016,11/4/2016,7,0,7
10/28/2016,10/28/2016,11/30/2016,33,0,33
10/28/2016,10/28/2016,11/30/2016,33,0,33
10/28/2016,10/28/2016,11/30/2016,33,0,33
10/28/2016,10/28/2016,11/30/2016,33,0,33
10/28/2016,10/28/2016,11/30/2016,33,0,33
10/28/2016,10/28/2016,11/30/2016,33,0,33
3/23/2015,3/23/2015,4/23/2015,31,0,31
3/23/2015,3/23/2015,4/23/2015,31,0,31
3/23/2015,3/23/2015,4/23/2015,31,0,31
3/26/2015,3/24/2015,4/27/2015,34,-2,32
3/26/2015,3/26/2015,6/10/2015,76,0,76
3/26/2015,3/26/2015,6/10/2015,76,0,76
5/22/2015,5/22/2015,5/29/2015,7,0,7
6/3/2015,6/3/2015,6/9/2015,6,0,6
6/3/2015,6/3/2015,6/9/2015,6,0,6
6/9/2015,6/5/2015,9/9/2015,96,-4,92
6/9/2015,6/5/2015,8/10/2015,66,-4,62
6/9/2015,6/5/2015,7/9/2015,34,-4,30
6/8/2015,6/8/2015,6/30/2015,22,0,22
6/8/2015,6/8/2015,6/9/2015,1,0,1
6/8/2015,6/8/2015,6/9/2015,1,0,1
6/8/2015,6/8/2015,6/29/2015,21,0,21
6/8/2015,6/8/2015,6/29/2015,21,0,21
6/8/2015,6/8/2015,6/29/2015,21,0,21
6/8/2015,6/8/2015,6/29/2015,21,0,21
6/10/2015,6/10/2015,6/17/2015,7,0,7
6/12/2015,6/10/2015,9/14/2015,96,-2,94
6/15/2015,6/11/2015,7/15/2015,34,-4,30
6/12/2015,6/12/2015,6/19/2015,7,0,7
6/15/2015,6/15/2015,6/22/2015,7,0,7
6/17/2015,6/17/2015,6/24/2015,7,0,7
6/17/2015,6/17/2015,6/24/2015,7,0,7
6/18/2015,6/17/2015,9/18/2015,93,-1,92
6/18/2015,6/17/2015,9/21/2015,96,-1,95
8/10/2016,8/8/2016,10/10/2016,63,-2,61
8/9/2016,8/9/2016,10/10/2016,62,0,62
8/10/2016,8/10/2016,8/17/2016,7,0,7
8/12/2016,8/12/2016,9/12/2016,31,0,31
8/12/2016,8/12/2016,9/12/2016,31,0,31
8/12/2016,8/12/2016,9/12/2016,31,0,31
8/12/2016,8/12/2016,9/13/2016,32,0,32
12/12/2016,12/12/2016,3/13/2017,91,0,91
12/12/2016,12/12/2016,12/19/2016,7,0,7
12/12/2016,12/12/2016,12/19/2016,7,0,7
12/12/2016,12/12/2016,1/11/2017,30,0,30
12/13/2016,12/13/2016,3/13/2017,90,0,90
1/10/2017,1/10/2017,4/10/2017,90,0,90
1/12/2017,1/12/2017,1/16/2017,4,0,4
1/20/2017,1/20/2017,1/27/2017,7,0,7
1/23/2017,1/23/2017,2/23/2017,31,0,31
5/29/2017,5/25/2017,6/5/2017,11,-4,7
5/25/2017,5/25/2017,7/25/2017,61,0,61
5/26/2017,5/26/2017,6/29/2017,34,0,34
5/26/2017,5/26/2017,5/30/2017,4,0,4
5/26/2017,5/26/2017,6/2/2017,7,0,7
5/26/2017,5/26/2017,6/2/2017,7,0,7
5/29/2017,5/26/2017,6/29/2017,34,-3,31
5/31/2017,5/30/2017,6/30/2017,31,-1,30
6/2/2017,6/1/2017,7/5/2017,34,-1,33
6/2/2017,6/1/2017,6/12/2017,11,-1,10
6/15/2017,6/15/2017,6/26/2017,11,0,11
6/20/2017,6/16/2017,8/21/2017,66,-4,62
7/17/2017,7/17/2017,7/24/2017,7,0,7
3/16/2015,3/16/2015,6/10/2015,86,0,86
3/16/2015,3/16/2015,4/16/2015,31,0,31
3/16/2015,3/16/2015,4/16/2015,31,0,31
3/16/2015,3/16/2015,3/20/2015,4,0,4
3/18/2015,3/17/2015,6/19/2015,94,-1,93
3/18/2015,3/18/2015,6/10/2015,84,0,84
3/23/2015,3/19/2015,6/23/2015,96,-4,92
3/23/2015,3/19/2015,3/30/2015,11,-4,7
3/19/2015,3/19/2015,4/24/2015,36,0,36
3/20/2015,3/20/2015,4/24/2015,35,0,35
9/9/2015,9/8/2015,12/7/2015,90,-1,89
9/9/2015,9/8/2015,10/12/2015,34,-1,33
9/10/2015,9/8/2015,12/10/2015,93,-2,91
9/9/2015,9/8/2015,10/12/2015,34,-1,33
9/14/2015,9/10/2015,12/14/2015,95,-4,91
9/10/2015,9/10/2015,10/14/2015,34,0,34
9/14/2015,9/10/2015,10/14/2015,34,-4,30
9/10/2015,9/10/2015,9/17/2015,7,0,7
9/10/2015,9/10/2015,9/17/2015,7,0,7
9/10/2015,9/10/2015,9/17/2015,7,0,7
9/10/2015,9/10/2015,10/13/2015,33,0,33
9/11/2015,9/11/2015,9/18/2015,7,0,7
9/15/2015,9/15/2015,10/19/2015,34,0,34
9/17/2015,9/15/2015,10/19/2015,34,-2,32
9/17/2015,9/15/2015,10/19/2015,34,-2,32
9/15/2015,9/15/2015,9/22/2015,7,0,7
8/3/2016,8/1/2016,8/10/2016,9,-2,7
9/2/2016,9/2/2016,12/5/2016,94,0,94
9/2/2016,9/2/2016,10/3/2016,31,0,31
9/2/2016,9/2/2016,10/3/2016,31,0,31
9/2/2016,9/2/2016,9/9/2016,7,0,7
9/6/2016,9/6/2016,9/13/2016,7,0,7
9/6/2016,9/6/2016,9/13/2016,7,0,7
9/6/2016,9/6/2016,12/6/2016,91,0,91
9/9/2016,9/7/2016,11/9/2016,63,-2,61
9/9/2016,9/7/2016,11/9/2016,63,-2,61
9/8/2016,9/8/2016,9/15/2016,7,0,7
9/8/2016,9/8/2016,10/11/2016,33,0,33
9/9/2016,9/9/2016,12/13/2016,95,0,95
9/9/2016,9/9/2016,9/16/2016,7,0,7
9/13/2016,9/13/2016,12/16/2016,94,0,94
9/13/2016,9/13/2016,9/20/2016,7,0,7
9/13/2016,9/13/2016,9/20/2016,7,0,7
9/16/2016,9/14/2016,10/17/2016,33,-2,31
10/28/2016,10/28/2016,11/10/2016,13,0,13
12/27/2016,12/27/2016,1/30/2017,34,0,34
1/19/2017,1/19/2017,4/19/2017,90,0,90
3/17/2015,3/17/2015,3/24/2015,7,0,7
3/17/2015,3/17/2015,3/24/2015,7,0,7
3/24/2015,3/20/2015,6/24/2015,96,-4,92
6/18/2015,6/18/2015,6/25/2015,7,0,7
7/9/2015,7/7/2015,8/10/2015,34,-2,32
7/7/2015,7/7/2015,7/13/2015,6,0,6
7/13/2015,7/10/2015,8/13/2015,34,-3,31
7/13/2015,7/13/2015,7/20/2015,7,0,7
7/15/2015,7/13/2015,8/17/2015,35,-2,33
7/15/2015,7/13/2015,8/17/2015,35,-2,33
7/16/2015,7/15/2015,8/17/2015,33,-1,32
7/16/2015,7/16/2015,7/23/2015,7,0,7
8/31/2015,8/31/2015,9/29/2015,29,0,29
8/31/2015,8/31/2015,9/28/2015,28,0,28
9/9/2015,9/7/2015,9/16/2015,9,-2,7
9/9/2015,9/7/2015,12/9/2015,93,-2,91
9/9/2015,9/7/2015,12/7/2015,91,-2,89
9/8/2015,9/8/2015,9/15/2015,7,0,7
9/8/2015,9/8/2015,9/15/2015,7,0,7
9/8/2015,9/8/2015,9/15/2015,7,0,7
9/8/2015,9/8/2015,9/29/2015,21,0,21
9/9/2015,9/9/2015,9/16/2015,7,0,7
9/10/2015,9/10/2015,12/10/2015,91,0,91
9/11/2015,9/10/2015,12/10/2015,91,-1,90
9/16/2015,9/16/2015,10/19/2015,33,0,33
10/7/2015,10/7/2015,10/14/2015,7,0,7
10/7/2015,10/7/2015,10/14/2015,7,0,7
6/27/2016,6/27/2016,7/5/2016,8,0,8
6/27/2016,6/27/2016,7/5/2016,8,0,8
6/27/2016,6/27/2016,7/5/2016,8,0,8
6/27/2016,6/27/2016,9/28/2016,93,0,93
6/27/2016,6/27/2016,9/30/2016,95,0,95
6/29/2016,6/28/2016,7/29/2016,31,-1,30
12/5/2016,12/5/2016,3/6/2017,91,0,91
12/5/2016,12/5/2016,12/12/2016,7,0,7
12/5/2016,12/5/2016,12/12/2016,7,0,7
12/6/2016,12/5/2016,12/14/2016,9,-1,8
12/5/2016,12/5/2016,3/6/2017,91,0,91
12/6/2016,12/5/2016,3/6/2017,91,-1,90
12/7/2016,12/6/2016,1/9/2017,34,-1,33
12/6/2016,12/6/2016,3/6/2017,90,0,90
12/7/2016,12/6/2016,3/8/2017,92,-1,91
12/6/2016,12/6/2016,3/6/2017,90,0,90
12/6/2016,12/6/2016,3/6/2017,90,0,90
12/6/2016,12/6/2016,12/13/2016,7,0,7
12/7/2016,12/6/2016,12/14/2016,8,-1,7
12/7/2016,12/7/2016,12/14/2016,7,0,7
12/7/2016,12/7/2016,12/14/2016,7,0,7
7/18/2017,7/18/2017,10/19/2017,93,0,93
7/24/2017,7/24/2017,10/24/2017,92,0,92
7/24/2017,7/24/2017,9/25/2017,63,0,63
6/10/2015,6/10/2015,6/17/2015,7,0,7
6/10/2015,6/10/2015,6/11/2015,1,0,1
6/10/2015,6/10/2015,6/11/2015,1,0,1
6/10/2015,6/10/2015,6/11/2015,1,0,1
6/15/2015,6/11/2015,7/15/2015,34,-4,30
6/15/2015,6/11/2015,7/15/2015,34,-4,30
6/15/2015,6/11/2015,6/22/2015,11,-4,7
6/11/2015,6/11/2015,6/18/2015,7,0,7
6/12/2015,6/12/2015,6/19/2015,7,0,7
6/16/2015,6/16/2015,9/16/2015,92,0,92
6/18/2015,6/16/2015,7/20/2015,34,-2,32
6/17/2015,6/16/2015,9/17/2015,93,-1,92
6/17/2015,6/16/2015,6/24/2015,8,-1,7
6/22/2015,6/18/2015,7/22/2015,34,-4,30
6/26/2015,6/26/2015,8/3/2015,38,0,38
6/26/2015,6/26/2015,8/3/2015,38,0,38
6/26/2015,6/26/2015,7/6/2015,10,0,10
6/26/2015,6/26/2015,7/2/2015,6,0,6
6/26/2015,6/26/2015,7/2/2015,6,0,6
6/26/2015,6/26/2015,7/2/2015,6,0,6
7/1/2015,6/29/2015,7/8/2015,9,-2,7
6/30/2015,6/30/2015,9/30/2015,92,0,92
6/30/2015,6/30/2015,8/4/2015,35,0,35
8/21/2015,8/19/2015,8/26/2015,7,-2,5
8/19/2015,8/19/2015,8/26/2015,7,0,7
8/19/2015,8/19/2015,8/26/2015,7,0,7
8/19/2015,8/19/2015,8/26/2015,7,0,7
8/20/2015,8/20/2015,9/21/2015,32,0,32
9/16/2015,9/16/2015,9/23/2015,7,0,7
9/16/2015,9/16/2015,9/23/2015,7,0,7
6/2/2016,6/2/2016,6/9/2016,7,0,7
6/2/2016,6/2/2016,6/9/2016,7,0,7
6/3/2016,6/3/2016,6/10/2016,7,0,7
6/3/2016,6/3/2016,6/10/2016,7,0,7
6/3/2016,6/3/2016,8/5/2016,63,0,63
6/29/2016,6/29/2016,7/6/2016,7,0,7
7/1/2016,7/1/2016,7/8/2016,7,0,7
8/2/2016,8/2/2016,9/2/2016,31,0,31
8/2/2016,8/2/2016,8/9/2016,7,0,7
8/25/2016,8/23/2016,9/26/2016,34,-2,32
1/19/2017,1/19/2017,4/19/2017,90,0,90
1/23/2017,1/19/2017,1/30/2017,11,-4,7
1/23/2017,1/19/2017,1/30/2017,11,-4,7
1/23/2017,1/19/2017,2/23/2017,35,-4,31
1/23/2017,1/19/2017,2/23/2017,35,-4,31
1/20/2017,1/20/2017,1/30/2017,10,0,10
2/6/2017,2/6/2017,5/9/2017,92,0,92
2/9/2017,2/7/2017,3/9/2017,30,-2,28
2/7/2017,2/7/2017,5/9/2017,91,0,91
2/7/2017,2/7/2017,2/15/2017,8,0,8
2/8/2017,2/8/2017,2/15/2017,7,0,7
2/8/2017,2/8/2017,2/15/2017,7,0,7
2/8/2017,2/8/2017,5/9/2017,90,0,90
2/9/2017,2/9/2017,3/9/2017,28,0,28
2/9/2017,2/9/2017,2/16/2017,7,0,7
2/13/2017,2/9/2017,3/13/2017,32,-4,28
2/13/2017,2/9/2017,4/13/2017,63,-4,59
2/13/2017,2/9/2017,2/20/2017,11,-4,7
2/14/2017,2/10/2017,5/15/2017,94,-4,90
9/17/2015,9/17/2015,9/18/2015,1,0,1
9/17/2015,9/17/2015,9/18/2015,1,0,1
9/18/2015,9/18/2015,9/25/2015,7,0,7
9/21/2015,9/21/2015,12/21/2015,91,0,91
9/28/2015,9/24/2015,10/28/2015,34,-4,30
9/28/2015,9/24/2015,10/28/2015,34,-4,30
9/28/2015,9/24/2015,11/30/2015,67,-4,63
9/30/2015,9/28/2015,11/2/2015,35,-2,33
9/30/2015,9/28/2015,10/7/2015,9,-2,7
9/30/2015,9/28/2015,11/30/2015,63,-2,61
9/29/2015,9/29/2015,11/6/2015,38,0,38
9/29/2015,9/29/2015,11/6/2015,38,0,38
9/29/2015,9/29/2015,10/6/2015,7,0,7
10/12/2015,10/12/2015,12/14/2015,63,0,63
10/6/2015,10/6/2015,11/9/2015,34,0,34
10/14/2015,10/12/2015,10/21/2015,9,-2,7
10/14/2015,10/12/2015,11/16/2015,35,-2,33
10/14/2015,10/12/2015,11/16/2015,35,-2,33
10/16/2015,10/16/2015,10/23/2015,7,0,7
10/16/2015,10/16/2015,10/23/2015,7,0,7
10/21/2015,10/21/2015,10/28/2015,7,0,7
10/21/2015,10/21/2015,10/28/2015,7,0,7
10/27/2015,10/26/2015,11/27/2015,32,-1,31
10/28/2015,10/26/2015,11/30/2015,35,-2,33
7/6/2016,7/6/2016,7/13/2016,7,0,7
7/6/2016,7/6/2016,7/13/2016,7,0,7
7/6/2016,7/6/2016,8/5/2016,30,0,30
7/8/2016,7/8/2016,7/15/2016,7,0,7
7/8/2016,7/8/2016,7/15/2016,7,0,7
9/7/2016,9/7/2016,12/6/2016,90,0,90
9/21/2016,9/21/2016,9/28/2016,7,0,7
9/21/2016,9/21/2016,10/21/2016,30,0,30
9/23/2016,9/21/2016,12/23/2016,93,-2,91
9/26/2016,9/22/2016,10/26/2016,34,-4,30
9/22/2016,9/22/2016,9/29/2016,7,0,7
9/22/2016,9/22/2016,9/29/2016,7,0,7
9/22/2016,9/22/2016,9/29/2016,7,0,7
2/27/2017,2/27/2017,3/27/2017,28,0,28
2/27/2017,2/27/2017,5/29/2017,91,0,91
2/27/2017,2/27/2017,3/31/2017,32,0,32
2/27/2017,2/27/2017,3/31/2017,32,0,32
2/27/2017,2/27/2017,3/31/2017,32,0,32
2/27/2017,2/27/2017,3/31/2017,32,0,32
2/27/2017,2/27/2017,3/31/2017,32,0,32
2/28/2017,2/28/2017,3/28/2017,28,0,28
2/28/2017,2/28/2017,4/28/2017,59,0,59
3/2/2017,2/28/2017,5/2/2017,63,-2,61
3/2/2017,2/28/2017,4/3/2017,34,-2,32
2/28/2017,2/28/2017,3/8/2017,8,0,8
7/31/2015,7/30/2015,8/7/2015,8,-1,7
8/5/2015,8/4/2015,9/7/2015,34,-1,33
8/5/2015,8/4/2015,9/7/2015,34,-1,33
8/5/2015,8/5/2015,10/6/2015,62,0,62
8/7/2015,8/7/2015,11/9/2015,94,0,94
8/7/2015,8/7/2015,8/14/2015,7,0,7
8/7/2015,8/7/2015,8/14/2015,7,0,7
8/10/2015,8/7/2015,9/30/2015,54,-3,51
8/12/2015,8/12/2015,8/19/2015,7,0,7
8/12/2015,8/12/2015,8/19/2015,7,0,7
8/12/2015,8/12/2015,8/19/2015,7,0,7
8/20/2015,8/14/2015,9/21/2015,38,-6,32
8/14/2015,8/14/2015,8/21/2015,7,0,7
8/14/2015,8/14/2015,8/21/2015,7,0,7
8/19/2015,8/19/2015,8/26/2015,7,0,7
8/19/2015,8/19/2015,8/26/2015,7,0,7
8/21/2015,8/21/2015,9/21/2015,31,0,31
8/21/2015,8/21/2015,8/28/2015,7,0,7
8/28/2015,8/28/2015,9/29/2015,32,0,32
8/28/2015,8/28/2015,9/4/2015,7,0,7
9/1/2015,9/1/2015,9/8/2015,7,0,7
9/1/2015,9/1/2015,10/1/2015,30,0,30
9/3/2015,9/3/2015,9/24/2015,21,0,21
9/7/2015,9/7/2015,12/7/2015,91,0,91
10/5/2015,10/5/2015,11/13/2015,39,0,39
10/5/2015,10/5/2015,10/13/2015,8,0,8
10/6/2015,10/6/2015,12/7/2015,62,0,62
10/6/2015,10/6/2015,11/6/2015,31,0,31
6/1/2016,6/1/2016,7/1/2016,30,0,30
6/15/2016,6/15/2016,6/22/2016,7,0,7
6/16/2016,6/16/2016,6/23/2016,7,0,7
6/16/2016,6/16/2016,6/23/2016,7,0,7
6/16/2016,6/16/2016,6/23/2016,7,0,7
6/16/2016,6/16/2016,6/23/2016,7,0,7
6/20/2016,6/16/2016,7/20/2016,34,-4,30
6/17/2016,6/17/2016,7/18/2016,31,0,31
6/17/2016,6/17/2016,6/24/2016,7,0,7
1/18/2017,1/18/2017,1/25/2017,7,0,7
1/18/2017,1/18/2017,1/25/2017,7,0,7
1/24/2017,1/24/2017,4/24/2017,90,0,90
1/27/2017,1/25/2017,2/27/2017,33,-2,31
1/30/2017,1/26/2017,2/28/2017,33,-4,29
1/30/2017,1/26/2017,2/28/2017,33,-4,29
1/30/2017,1/26/2017,2/6/2017,11,-4,7
1/27/2017,1/27/2017,2/27/2017,31,0,31
1/27/2017,1/27/2017,2/8/2017,12,0,12
1/27/2017,1/27/2017,2/8/2017,12,0,12
2/14/2017,2/14/2017,2/21/2017,7,0,7
2/14/2017,2/14/2017,2/22/2017,8,0,8
3/6/2017,3/2/2017,3/13/2017,11,-4,7
5/11/2017,5/11/2017,6/12/2017,32,0,32
5/15/2017,5/11/2017,8/14/2017,95,-4,91
10/27/2015,10/26/2015,11/4/2015,9,-1,8
10/29/2015,10/28/2015,11/6/2015,9,-1,8
11/2/2015,10/29/2015,12/2/2015,34,-4,30
11/2/2015,10/29/2015,12/2/2015,34,-4,30
10/29/2015,10/29/2015,11/30/2015,32,0,32
10/30/2015,10/30/2015,11/6/2015,7,0,7
10/30/2015,10/30/2015,11/6/2015,7,0,7
10/30/2015,10/30/2015,11/6/2015,7,0,7
11/2/2015,11/2/2015,12/2/2015,30,0,30
11/2/2015,11/2/2015,12/2/2015,30,0,30
11/2/2015,11/2/2015,12/7/2015,35,0,35
11/13/2015,11/12/2015,11/20/2015,8,-1,7
11/12/2015,11/12/2015,11/19/2015,7,0,7
11/12/2015,11/12/2015,11/19/2015,7,0,7
11/16/2015,11/12/2015,12/16/2015,34,-4,30
11/16/2015,11/12/2015,12/16/2015,34,-4,30
11/13/2015,11/13/2015,11/20/2015,7,0,7
11/13/2015,11/13/2015,12/14/2015,31,0,31
11/16/2015,11/16/2015,12/18/2015,32,0,32
11/19/2015,11/17/2015,12/21/2015,34,-2,32
11/19/2015,11/17/2015,12/21/2015,34,-2,32
11/18/2015,11/18/2015,11/25/2015,7,0,7
11/20/2015,11/18/2015,2/22/2016,96,-2,94
11/20/2015,11/18/2015,11/27/2015,9,-2,7
11/19/2015,11/19/2015,11/27/2015,8,0,8
11/19/2015,11/19/2015,11/27/2015,8,0,8
11/23/2015,11/23/2015,12/23/2015,30,0,30
11/24/2015,11/24/2015,2/24/2016,92,0,92
11/26/2015,11/24/2015,2/26/2016,94,-2,92
11/24/2015,11/24/2015,12/1/2015,7,0,7
11/26/2015,11/25/2015,12/29/2015,34,-1,33
8/24/2016,8/24/2016,8/31/2016,7,0,7
8/24/2016,8/24/2016,10/24/2016,61,0,61
8/26/2016,8/24/2016,11/25/2016,93,-2,91
8/26/2016,8/26/2016,9/26/2016,31,0,31
3/26/2015,3/24/2015,4/27/2015,34,-2,32
3/24/2015,3/24/2015,4/24/2015,31,0,31
3/24/2015,3/24/2015,3/31/2015,7,0,7
3/24/2015,3/24/2015,3/31/2015,7,0,7
8/25/2015,8/25/2015,9/1/2015,7,0,7
8/25/2015,8/25/2015,9/1/2015,7,0,7
8/26/2015,8/26/2015,9/2/2015,7,0,7
8/26/2015,8/26/2015,9/2/2015,7,0,7
8/26/2015,8/26/2015,9/2/2015,7,0,7
11/4/2015,11/4/2015,11/12/2015,8,0,8
11/10/2015,11/10/2015,11/18/2015,8,0,8
12/9/2015,12/9/2015,12/30/2015,21,0,21
12/10/2015,12/9/2015,1/11/2016,33,-1,32
3/1/2016,3/1/2016,3/9/2016,8,0,8
3/4/2016,3/2/2016,4/28/2016,57,-2,55
3/3/2016,3/3/2016,3/10/2016,7,0,7
3/3/2016,3/3/2016,3/10/2016,7,0,7
3/3/2016,3/3/2016,4/4/2016,32,0,32
3/3/2016,3/3/2016,4/4/2016,32,0,32
3/3/2016,3/3/2016,6/3/2016,92,0,92
3/3/2016,3/3/2016,4/7/2016,35,0,35
3/4/2016,3/4/2016,3/11/2016,7,0,7
3/4/2016,3/4/2016,6/2/2016,90,0,90
5/23/2016,5/23/2016,5/31/2016,8,0,8
5/26/2016,5/24/2016,8/26/2016,94,-2,92
5/15/2017,5/11/2017,6/15/2017,35,-4,31
5/11/2017,5/11/2017,5/18/2017,7,0,7
5/11/2017,5/11/2017,5/18/2017,7,0,7
7/3/2017,7/3/2017,8/3/2017,31,0,31
8/10/2017,8/10/2017,8/17/2017,7,0,7
8/16/2017,8/10/2017,9/14/2017,35,-6,29
8/21/2017,8/17/2017,10/23/2017,67,-4,63
8/18/2017,8/18/2017,8/25/2017,7,0,7
9/7/2017,9/7/2017,9/27/2017,20,0,20
3/26/2015,3/25/2015,4/27/2015,33,-1,32
11/26/2015,11/25/2015,12/4/2015,9,-1,8
12/14/2015,12/14/2015,1/14/2016,31,0,31
12/15/2015,12/14/2015,12/23/2015,9,-1,8
12/16/2015,12/14/2015,1/18/2016,35,-2,33
12/16/2015,12/14/2015,1/18/2016,35,-2,33
12/14/2015,12/14/2015,12/21/2015,7,0,7
12/14/2015,12/14/2015,12/21/2015,7,0,7
12/14/2015,12/14/2015,1/15/2016,32,0,32
12/15/2015,12/15/2015,12/22/2015,7,0,7
12/16/2015,12/15/2015,12/23/2015,8,-1,7
12/16/2015,12/16/2015,12/23/2015,7,0,7
12/18/2015,12/16/2015,12/31/2015,15,-2,13
12/23/2015,12/23/2015,3/23/2016,91,0,91
12/24/2015,12/24/2015,12/31/2015,7,0,7
12/24/2015,12/24/2015,12/31/2015,7,0,7
12/24/2015,12/24/2015,12/31/2015,7,0,7
12/28/2015,12/28/2015,1/4/2016,7,0,7
1/25/2016,1/21/2016,2/25/2016,35,-4,31
1/25/2016,1/21/2016,2/25/2016,35,-4,31
1/21/2016,1/21/2016,1/28/2016,7,0,7
1/21/2016,1/21/2016,1/28/2016,7,0,7
1/22/2016,1/22/2016,4/22/2016,91,0,91
1/26/2016,1/25/2016,2/3/2016,9,-1,8
1/26/2016,1/26/2016,2/2/2016,7,0,7
1/28/2016,1/26/2016,2/3/2016,8,-2,6
2/2/2016,1/29/2016,5/2/2016,94,-4,90
2/1/2016,2/1/2016,3/1/2016,29,0,29
2/1/2016,2/1/2016,5/2/2016,91,0,91
2/3/2016,2/3/2016,2/10/2016,7,0,7
2/8/2016,2/4/2016,4/8/2016,64,-4,60
2/4/2016,2/4/2016,2/11/2016,7,0,7
2/4/2016,2/4/2016,2/11/2016,7,0,7
2/4/2016,2/4/2016,2/11/2016,7,0,7
5/30/2016,5/26/2016,6/30/2016,35,-4,31
5/26/2016,5/26/2016,6/27/2016,32,0,32
5/26/2016,5/26/2016,6/27/2016,32,0,32
5/27/2016,5/27/2016,6/30/2016,34,0,34
5/31/2016,5/27/2016,6/30/2016,34,-4,30
5/27/2016,5/27/2016,6/30/2016,34,0,34
5/27/2016,5/27/2016,6/30/2016,34,0,34
5/31/2016,5/27/2016,6/30/2016,34,-4,30
5/27/2016,5/27/2016,6/30/2016,34,0,34
5/27/2016,5/27/2016,6/30/2016,34,0,34
7/21/2016,7/20/2016,10/21/2016,93,-1,92
2/22/2016,2/19/2016,5/23/2016,94,-3,91
10/14/2016,10/14/2016,10/21/2016,7,0,7
10/18/2016,10/18/2016,10/25/2016,7,0,7
10/18/2016,10/18/2016,10/25/2016,7,0,7
10/18/2016,10/18/2016,10/25/2016,7,0,7
10/19/2016,10/19/2016,10/26/2016,7,0,7
10/19/2016,10/19/2016,1/17/2017,90,0,90
10/19/2016,10/19/2016,11/18/2016,30,0,30
10/19/2016,10/19/2016,11/18/2016,30,0,30
4/11/2017,4/10/2017,5/11/2017,31,-1,30
4/11/2017,4/11/2017,4/20/2017,9,0,9
4/11/2017,4/11/2017,4/20/2017,9,0,9
8/7/2017,8/7/2017,9/7/2017,31,0,31
12/9/2015,12/9/2015,12/16/2015,7,0,7
12/9/2015,12/9/2015,12/16/2015,7,0,7
2/4/2016,2/4/2016,5/4/2016,90,0,90
2/9/2016,2/5/2016,4/11/2016,66,-4,62
2/10/2016,2/10/2016,2/17/2016,7,0,7
2/12/2016,2/10/2016,5/12/2016,92,-2,90
2/15/2016,2/12/2016,3/16/2016,33,-3,30
2/16/2016,2/16/2016,3/16/2016,29,0,29
2/16/2016,2/16/2016,2/23/2016,7,0,7
2/16/2016,2/16/2016,2/23/2016,7,0,7
2/16/2016,2/16/2016,2/23/2016,7,0,7
2/16/2016,2/16/2016,2/23/2016,7,0,7
2/18/2016,2/16/2016,3/18/2016,31,-2,29
2/22/2016,2/18/2016,5/23/2016,95,-4,91
2/22/2016,2/18/2016,4/22/2016,64,-4,60
4/4/2016,4/4/2016,4/11/2016,7,0,7
4/19/2016,4/18/2016,5/23/2016,35,-1,34
4/18/2016,4/18/2016,5/18/2016,30,0,30
4/18/2016,4/18/2016,4/25/2016,7,0,7
4/18/2016,4/18/2016,4/25/2016,7,0,7
4/18/2016,4/18/2016,4/25/2016,7,0,7
4/18/2016,4/18/2016,4/25/2016,7,0,7
4/20/2016,4/19/2016,7/21/2016,93,-1,92
7/29/2016,7/27/2016,8/31/2016,35,-2,33
7/27/2016,7/27/2016,8/31/2016,35,0,35
7/27/2016,7/27/2016,8/31/2016,35,0,35
7/29/2016,7/27/2016,8/31/2016,35,-2,33
7/27/2016,7/27/2016,8/31/2016,35,0,35
7/27/2016,7/27/2016,8/31/2016,35,0,35
7/27/2016,7/27/2016,8/31/2016,35,0,35
6/8/2016,6/6/2016,6/15/2016,9,-2,7
6/9/2016,6/7/2016,9/9/2016,94,-2,92
6/8/2016,6/8/2016,6/9/2016,1,0,1
6/13/2016,6/9/2016,7/13/2016,34,-4,30
6/13/2016,6/9/2016,8/16/2016,68,-4,64
6/9/2016,6/9/2016,6/16/2016,7,0,7
6/9/2016,6/9/2016,6/16/2016,7,0,7
6/9/2016,6/9/2016,6/16/2016,7,0,7
6/9/2016,6/9/2016,6/29/2016,20,0,20
6/10/2016,6/10/2016,9/9/2016,91,0,91
6/10/2016,6/10/2016,6/17/2016,7,0,7
6/10/2016,6/10/2016,6/17/2016,7,0,7
12/4/2015,12/2/2015,3/4/2016,93,-2,91
3/6/2017,3/6/2017,6/6/2017,92,0,92
3/6/2017,3/6/2017,6/6/2017,92,0,92
3/6/2017,3/6/2017,6/6/2017,92,0,92
3/7/2017,3/7/2017,3/15/2017,8,0,8
3/9/2017,3/9/2017,4/10/2017,32,0,32
7/8/2016,7/8/2016,9/2/2016,56,0,56
6/28/2016,6/28/2016,7/5/2016,7,0,7
6/28/2016,6/28/2016,9/28/2016,92,0,92
6/28/2016,6/28/2016,7/29/2016,31,0,31
6/28/2016,6/28/2016,7/29/2016,31,0,31
7/13/2016,7/11/2016,8/16/2016,36,-2,34
7/11/2016,7/11/2016,7/18/2016,7,0,7
7/12/2016,7/12/2016,7/19/2016,7,0,7
7/12/2016,7/12/2016,7/19/2016,7,0,7
7/12/2016,7/12/2016,7/19/2016,7,0,7
7/12/2016,7/12/2016,8/12/2016,31,0,31
7/14/2016,7/14/2016,7/21/2016,7,0,7
7/20/2016,7/19/2016,10/21/2016,94,-1,93
7/20/2016,7/20/2016,7/27/2016,7,0,7
7/20/2016,7/20/2016,7/27/2016,7,0,7
7/20/2016,7/20/2016,7/27/2016,7,0,7
7/21/2016,7/21/2016,7/28/2016,7,0,7
7/21/2016,7/21/2016,8/22/2016,32,0,32
7/21/2016,7/21/2016,7/29/2016,8,0,8
7/21/2016,7/21/2016,7/29/2016,8,0,8
7/27/2016,7/26/2016,8/3/2016,8,-1,7
7/28/2016,7/28/2016,8/29/2016,32,0,32
7/28/2016,7/28/2016,9/1/2016,35,0,35
7/28/2016,7/28/2016,8/26/2016,29,0,29
7/29/2016,7/29/2016,8/5/2016,7,0,7
7/29/2016,7/29/2016,8/5/2016,7,0,7
7/29/2016,7/29/2016,8/5/2016,7,0,7
8/17/2016,8/17/2016,8/24/2016,7,0,7
5/26/2015,5/26/2015,6/2/2015,7,0,7
5/26/2015,5/26/2015,6/2/2015,7,0,7
5/26/2015,5/26/2015,6/26/2015,31,0,31
5/29/2015,5/27/2015,6/30/2015,34,-2,32
5/29/2015,5/27/2015,6/30/2015,34,-2,32
3/21/2016,3/21/2016,6/21/2016,92,0,92
3/23/2016,3/21/2016,6/23/2016,94,-2,92
3/22/2016,3/22/2016,3/29/2016,7,0,7
3/23/2016,3/22/2016,3/30/2016,8,-1,7
4/29/2016,4/29/2016,5/6/2016,7,0,7
4/29/2016,4/29/2016,5/6/2016,7,0,7
10/12/2016,10/12/2016,10/19/2016,7,0,7
10/13/2016,10/13/2016,10/20/2016,7,0,7
10/13/2016,10/13/2016,10/20/2016,7,0,7
10/13/2016,10/13/2016,10/20/2016,7,0,7
10/17/2016,10/17/2016,1/18/2017,93,0,93
10/20/2016,10/20/2016,10/27/2016,7,0,7
10/20/2016,10/20/2016,10/27/2016,7,0,7
10/24/2016,10/20/2016,11/25/2016,36,-4,32
10/21/2016,10/21/2016,11/21/2016,31,0,31
10/21/2016,10/21/2016,1/19/2017,90,0,90
10/21/2016,10/21/2016,10/28/2016,7,0,7
10/21/2016,10/21/2016,10/28/2016,7,0,7
11/23/2016,11/21/2016,2/23/2017,94,-2,92
11/23/2016,11/21/2016,11/30/2016,9,-2,7
11/21/2016,11/21/2016,11/28/2016,7,0,7
11/21/2016,11/21/2016,11/28/2016,7,0,7
11/21/2016,11/21/2016,11/28/2016,7,0,7
12/30/2016,12/29/2016,3/2/2017,63,-1,62
1/3/2017,12/30/2016,1/11/2017,12,-4,8
1/4/2017,1/4/2017,1/11/2017,7,0,7
1/4/2017,1/4/2017,1/11/2017,7,0,7
1/4/2017,1/4/2017,4/6/2017,92,0,92
1/4/2017,1/4/2017,4/6/2017,92,0,92
1/6/2017,1/6/2017,1/13/2017,7,0,7
1/9/2017,1/9/2017,2/9/2017,31,0,31
1/9/2017,1/9/2017,1/17/2017,8,0,8
1/12/2017,1/10/2017,1/16/2017,6,-2,4
1/19/2017,1/17/2017,2/20/2017,34,-2,32
1/18/2017,1/17/2017,2/20/2017,34,-1,33
2/16/2017,2/16/2017,5/18/2017,91,0,91
2/16/2017,2/16/2017,5/18/2017,91,0,91
2/16/2017,2/16/2017,2/23/2017,7,0,7
2/22/2017,2/21/2017,3/23/2017,30,-1,29
2/22/2017,2/21/2017,5/23/2017,91,-1,90
2/22/2017,2/21/2017,4/24/2017,62,-1,61
3/3/2017,3/3/2017,6/6/2017,95,0,95
3/16/2017,3/16/2017,6/16/2017,92,0,92
3/16/2017,3/16/2017,6/15/2017,91,0,91
3/17/2017,3/17/2017,4/21/2017,35,0,35
3/20/2017,3/17/2017,6/21/2017,96,-3,93
3/17/2017,3/17/2017,3/24/2017,7,0,7
3/17/2017,3/17/2017,3/24/2017,7,0,7
3/23/2017,3/23/2017,5/23/2017,61,0,61
3/23/2017,3/23/2017,6/27/2017,96,0,96
3/28/2017,3/24/2017,4/28/2017,35,-4,31
3/24/2017,3/24/2017,3/31/2017,7,0,7
2/9/2015,2/9/2015,3/9/2015,28,0,28
2/10/2015,2/10/2015,2/17/2015,7,0,7
2/12/2015,2/10/2015,3/12/2015,30,-2,28
2/13/2015,2/11/2015,5/13/2015,91,-2,89
2/12/2015,2/12/2015,5/12/2015,89,0,89
2/13/2015,2/13/2015,3/16/2015,31,0,31
2/13/2015,2/13/2015,3/16/2015,31,0,31
2/13/2015,2/13/2015,2/20/2015,7,0,7
2/19/2015,2/18/2015,4/20/2015,61,-1,60
2/19/2015,2/19/2015,3/20/2015,29,0,29
2/23/2015,2/23/2015,3/2/2015,7,0,7
2/26/2015,2/25/2015,3/27/2015,30,-1,29
4/27/2015,4/23/2015,5/27/2015,34,-4,30
4/27/2015,4/23/2015,5/27/2015,34,-4,30
4/27/2015,4/23/2015,7/27/2015,95,-4,91
4/23/2015,4/23/2015,5/26/2015,33,0,33
3/9/2016,3/9/2016,3/16/2016,7,0,7
3/11/2016,3/9/2016,4/12/2016,34,-2,32
3/11/2016,3/9/2016,4/11/2016,33,-2,31
3/9/2016,3/9/2016,3/16/2016,7,0,7
3/9/2016,3/9/2016,3/16/2016,7,0,7
3/10/2016,3/9/2016,6/15/2016,98,-1,97
3/11/2016,3/11/2016,3/18/2016,7,0,7
11/25/2016,11/24/2016,12/27/2016,33,-1,32
11/25/2016,11/24/2016,12/27/2016,33,-1,32
11/25/2016,11/24/2016,2/24/2017,92,-1,91
8/17/2016,8/17/2016,8/24/2016,7,0,7
10/19/2016,10/17/2016,11/21/2016,35,-2,33
10/19/2016,10/17/2016,11/21/2016,35,-2,33
11/3/2016,11/3/2016,11/10/2016,7,0,7
11/3/2016,11/3/2016,11/10/2016,7,0,7
11/3/2016,11/3/2016,2/6/2017,95,0,95
11/4/2016,11/3/2016,2/6/2017,95,-1,94
11/29/2016,11/29/2016,12/6/2016,7,0,7
11/29/2016,11/29/2016,12/29/2016,30,0,30
12/1/2016,12/1/2016,12/9/2016,8,0,8
12/1/2016,12/1/2016,12/9/2016,8,0,8
12/14/2016,12/12/2016,3/14/2017,92,-2,90
12/14/2016,12/12/2016,1/16/2017,35,-2,33
12/19/2016,12/19/2016,3/14/2017,85,0,85
12/19/2016,12/19/2016,12/23/2016,4,0,4
12/19/2016,12/19/2016,12/28/2016,9,0,9
12/20/2016,12/20/2016,12/27/2016,7,0,7
12/20/2016,12/20/2016,12/27/2016,7,0,7
12/22/2016,12/21/2016,2/23/2017,64,-1,63
12/21/2016,12/21/2016,3/21/2017,90,0,90
12/21/2016,12/21/2016,1/23/2017,33,0,33
12/21/2016,12/21/2016,12/28/2016,7,0,7
12/21/2016,12/21/2016,12/28/2016,7,0,7
12/21/2016,12/21/2016,12/28/2016,7,0,7
12/22/2016,12/22/2016,1/3/2017,12,0,12
12/22/2016,12/22/2016,1/3/2017,12,0,12
12/22/2016,12/22/2016,3/23/2017,91,0,91
12/22/2016,12/22/2016,1/23/2017,32,0,32
12/23/2016,12/23/2016,1/3/2017,11,0,11
1/13/2015,1/12/2015,3/26/2015,73,-1,72
1/13/2015,1/13/2015,3/26/2015,72,0,72
1/13/2015,1/13/2015,3/26/2015,72,0,72
1/13/2015,1/13/2015,1/20/2015,7,0,7
1/13/2015,1/13/2015,2/13/2015,31,0,31
1/15/2015,1/13/2015,2/17/2015,35,-2,33
1/16/2015,1/16/2015,1/23/2015,7,0,7
1/27/2015,1/27/2015,2/3/2015,7,0,7
11/4/2015,11/4/2015,11/11/2015,7,0,7
11/5/2015,11/5/2015,2/5/2016,92,0,92
11/9/2015,11/5/2015,12/9/2015,34,-4,30
11/5/2015,11/5/2015,12/7/2015,32,0,32
11/6/2015,11/6/2015,11/13/2015,7,0,7
11/6/2015,11/6/2015,12/16/2015,40,0,40
11/6/2015,11/6/2015,12/7/2015,31,0,31
11/6/2015,11/6/2015,12/7/2015,31,0,31
11/6/2015,11/6/2015,12/7/2015,31,0,31
11/12/2015,11/9/2015,2/12/2016,95,-3,92
11/12/2015,11/10/2015,12/14/2015,34,-2,32
11/12/2015,11/10/2015,12/14/2015,34,-2,32
11/12/2015,11/10/2015,12/14/2015,34,-2,32
11/12/2015,11/10/2015,12/11/2015,31,-2,29
11/10/2015,11/10/2015,12/10/2015,30,0,30
11/10/2015,11/10/2015,12/10/2015,30,0,30
3/24/2017,3/24/2017,3/31/2017,7,0,7
3/24/2017,3/24/2017,3/31/2017,7,0,7
4/20/2017,4/19/2017,4/26/2017,7,-1,6
4/20/2017,4/20/2017,5/22/2017,32,0,32
4/24/2017,4/20/2017,7/24/2017,95,-4,91
4/24/2017,4/20/2017,5/24/2017,34,-4,30
4/25/2017,4/21/2017,5/2/2017,11,-4,7
4/27/2017,4/25/2017,5/29/2017,34,-2,32
7/24/2017,7/24/2017,7/31/2017,7,0,7
7/25/2017,7/25/2017,8/25/2017,31,0,31
7/25/2017,7/25/2017,10/25/2017,92,0,92
7/27/2017,7/27/2017,8/4/2017,8,0,8
7/27/2017,7/27/2017,8/4/2017,8,0,8
7/28/2017,7/27/2017,8/31/2017,35,-1,34
7/28/2017,7/27/2017,8/7/2017,11,-1,10
7/31/2017,7/31/2017,8/31/2017,31,0,31
8/23/2017,8/23/2017,8/24/2017,1,0,1
3/31/2016,3/30/2016,4/28/2016,29,-1,28
4/4/2016,3/30/2016,4/1/2016,2,-5,-3
3/31/2016,3/31/2016,4/8/2016,8,0,8
3/31/2016,3/31/2016,4/1/2016,1,0,1
4/1/2016,4/1/2016,4/8/2016,7,0,7
9/23/2016,9/23/2016,9/30/2016,7,0,7
9/28/2016,9/26/2016,10/5/2016,9,-2,7
9/26/2016,9/26/2016,12/27/2016,92,0,92
9/26/2016,9/26/2016,12/23/2016,88,0,88
9/29/2016,9/27/2016,11/2/2016,36,-2,34
10/26/2016,10/24/2016,11/2/2016,9,-2,7
10/26/2016,10/24/2016,11/28/2016,35,-2,33
10/24/2016,10/24/2016,10/31/2016,7,0,7
10/25/2016,10/25/2016,11/2/2016,8,0,8
10/25/2016,10/25/2016,11/2/2016,8,0,8
10/26/2016,10/25/2016,11/28/2016,34,-1,33
11/25/2016,11/25/2016,12/2/2016,7,0,7
2/28/2017,2/28/2017,3/28/2017,28,0,28
2/28/2017,2/28/2017,3/28/2017,28,0,28
1/30/2017,1/30/2017,2/6/2017,7,0,7
1/30/2017,1/30/2017,2/28/2017,29,0,29
1/30/2017,1/30/2017,2/28/2017,29,0,29
1/30/2017,1/30/2017,2/28/2017,29,0,29
1/30/2017,1/30/2017,2/28/2017,29,0,29
1/30/2017,1/30/2017,2/28/2017,29,0,29
1/30/2017,1/30/2017,2/28/2017,29,0,29
2/2/2017,1/31/2017,3/2/2017,30,-2,28
2/1/2017,2/1/2017,2/8/2017,7,0,7
2/1/2017,2/1/2017,2/8/2017,7,0,7
2/1/2017,2/1/2017,2/8/2017,7,0,7
2/3/2017,2/3/2017,2/10/2017,7,0,7
2/3/2017,2/3/2017,5/8/2017,94,0,94
2/6/2017,2/3/2017,5/8/2017,94,-3,91
2/10/2017,2/10/2017,3/10/2017,28,0,28
2/10/2017,2/10/2017,2/17/2017,7,0,7
2/13/2017,2/13/2017,3/13/2017,28,0,28
2/13/2017,2/13/2017,5/15/2017,91,0,91
2/16/2017,2/14/2017,3/16/2017,30,-2,28
3/3/2017,3/3/2017,3/10/2017,7,0,7
3/3/2017,3/3/2017,3/10/2017,7,0,7
3/16/2017,3/14/2017,4/18/2017,35,-2,33
3/15/2017,3/15/2017,4/18/2017,34,0,34
3/15/2017,3/15/2017,3/22/2017,7,0,7
3/15/2017,3/15/2017,3/22/2017,7,0,7
3/15/2017,3/15/2017,3/22/2017,7,0,7
3/17/2017,3/16/2017,4/20/2017,35,-1,34
3/17/2017,3/16/2017,3/27/2017,11,-1,10
6/29/2015,6/29/2015,8/4/2015,36,0,36
6/29/2015,6/29/2015,8/4/2015,36,0,36
6/29/2015,6/29/2015,6/30/2015,1,0,1
6/29/2015,6/29/2015,7/6/2015,7,0,7
6/29/2015,6/29/2015,7/6/2015,7,0,7
6/30/2015,6/30/2015,8/5/2015,36,0,36
6/30/2015,6/30/2015,7/6/2015,6,0,6
6/30/2015,6/30/2015,7/6/2015,6,0,6
4/12/2016,4/12/2016,4/20/2016,8,0,8
5/11/2016,5/11/2016,8/11/2016,92,0,92
3/16/2017,3/16/2017,6/16/2017,92,0,92
3/27/2017,3/27/2017,4/27/2017,31,0,31
3/28/2017,3/28/2017,4/5/2017,8,0,8
3/30/2017,3/30/2017,5/30/2017,61,0,61
3/30/2017,3/30/2017,5/30/2017,61,0,61
4/5/2017,4/5/2017,4/12/2017,7,0,7
4/5/2017,4/5/2017,4/12/2017,7,0,7
4/5/2017,4/5/2017,4/12/2017,7,0,7
4/5/2017,4/5/2017,4/12/2017,7,0,7
4/5/2017,4/5/2017,7/7/2017,93,0,93
4/12/2017,4/12/2017,4/19/2017,7,0,7
4/12/2017,4/12/2017,4/19/2017,7,0,7
4/13/2017,4/13/2017,5/18/2017,35,0,35
4/13/2017,4/13/2017,7/18/2017,96,0,96
4/27/2017,4/26/2017,5/31/2017,35,-1,34
4/26/2017,4/26/2017,5/3/2017,7,0,7
4/26/2017,4/26/2017,5/3/2017,7,0,7
4/26/2017,4/26/2017,5/3/2017,7,0,7
4/27/2017,4/26/2017,5/29/2017,33,-1,32
4/27/2017,4/27/2017,5/29/2017,32,0,32
4/27/2017,4/27/2017,4/28/2017,1,0,1
4/27/2017,4/27/2017,5/31/2017,34,0,34
4/27/2017,4/27/2017,5/4/2017,7,0,7
4/27/2017,4/27/2017,5/31/2017,34,0,34
4/27/2017,4/27/2017,5/31/2017,34,0,34
4/27/2017,4/27/2017,5/31/2017,34,0,34
4/27/2017,4/27/2017,5/31/2017,34,0,34
4/27/2017,4/27/2017,5/31/2017,34,0,34
4/27/2017,4/27/2017,5/31/2017,34,0,34
3/23/2016,3/23/2016,3/29/2016,6,0,6
5/2/2016,4/28/2016,8/2/2016,96,-4,92
11/23/2016,11/23/2016,12/7/2016,14,0,14
11/23/2016,11/23/2016,11/30/2016,7,0,7
11/23/2016,11/23/2016,12/1/2016,8,0,8
12/12/2016,12/8/2016,2/13/2017,67,-4,63
12/12/2016,12/8/2016,1/12/2017,35,-4,31
12/12/2016,12/8/2016,3/13/2017,95,-4,91
12/9/2016,12/9/2016,12/16/2016,7,0,7
12/9/2016,12/9/2016,12/16/2016,7,0,7
12/9/2016,12/9/2016,12/16/2016,7,0,7
12/9/2016,12/9/2016,12/16/2016,7,0,7
1/2/2017,1/2/2017,2/28/2017,57,0,57
1/5/2017,1/3/2017,1/12/2017,9,-2,7
1/3/2017,1/3/2017,4/3/2017,90,0,90
1/5/2017,1/5/2017,1/12/2017,7,0,7
1/9/2017,1/5/2017,3/9/2017,63,-4,59
1/9/2017,1/5/2017,3/9/2017,63,-4,59
1/9/2017,1/5/2017,2/9/2017,35,-4,31
1/5/2017,1/5/2017,4/7/2017,92,0,92
1/6/2017,1/5/2017,7/5/2017,181,-1,180
2/2/2017,2/2/2017,5/3/2017,90,0,90
2/3/2017,2/3/2017,2/6/2017,3,0,3
2/6/2017,2/3/2017,5/8/2017,94,-3,91
5/7/2015,5/5/2015,6/8/2015,34,-2,32
5/5/2015,5/5/2015,8/5/2015,92,0,92
5/11/2015,5/7/2015,6/11/2015,35,-4,31
5/8/2015,5/7/2015,6/9/2015,33,-1,32
5/8/2015,5/8/2015,6/8/2015,31,0,31
5/8/2015,5/8/2015,5/15/2015,7,0,7
5/11/2015,5/11/2015,5/18/2015,7,0,7
5/12/2015,5/12/2015,6/12/2015,31,0,31
5/18/2015,5/13/2015,6/19/2015,37,-5,32
5/13/2015,5/13/2015,6/15/2015,33,0,33
5/13/2015,5/13/2015,6/15/2015,33,0,33
5/13/2015,5/13/2015,5/20/2015,7,0,7
5/13/2015,5/13/2015,5/20/2015,7,0,7
5/19/2015,5/19/2015,5/26/2015,7,0,7
5/19/2015,5/19/2015,5/26/2015,7,0,7
5/20/2015,5/20/2015,6/22/2015,33,0,33
5/20/2015,5/20/2015,5/27/2015,7,0,7
5/21/2015,5/21/2015,6/22/2015,32,0,32
5/26/2015,5/22/2015,6/26/2015,35,-4,31
4/15/2016,4/13/2016,6/15/2016,63,-2,61
4/14/2016,4/13/2016,5/17/2016,34,-1,33
4/13/2016,4/13/2016,4/20/2016,7,0,7
4/15/2016,4/15/2016,4/22/2016,7,0,7
4/27/2017,4/27/2017,5/31/2017,34,0,34
5/2/2017,4/28/2017,7/3/2017,66,-4,62
5/3/2017,5/3/2017,5/12/2017,9,0,9
5/3/2017,5/3/2017,5/12/2017,9,0,9
5/4/2017,5/4/2017,5/11/2017,7,0,7
5/4/2017,5/4/2017,5/12/2017,8,0,8
5/9/2017,5/5/2017,5/16/2017,11,-4,7
5/5/2017,5/5/2017,5/12/2017,7,0,7
5/5/2017,5/5/2017,5/12/2017,7,0,7
5/5/2017,5/5/2017,5/12/2017,7,0,7
7/27/2017,7/27/2017,10/27/2017,92,0,92
7/27/2017,7/27/2017,8/28/2017,32,0,32
7/27/2017,7/27/2017,8/3/2017,7,0,7
7/27/2017,7/27/2017,8/3/2017,7,0,7
7/27/2017,7/27/2017,8/3/2017,7,0,7
7/27/2017,7/27/2017,8/3/2017,7,0,7
7/28/2017,7/28/2017,8/28/2017,31,0,31
7/28/2017,7/28/2017,8/31/2017,34,0,34
7/28/2017,7/28/2017,8/31/2017,34,0,34
7/28/2017,7/28/2017,8/31/2017,34,0,34
7/28/2017,7/28/2017,8/31/2017,34,0,34
7/28/2017,7/28/2017,8/31/2017,34,0,34
7/31/2017,7/28/2017,8/8/2017,11,-3,8
8/7/2017,8/3/2017,9/7/2017,35,-4,31
8/7/2017,8/3/2017,8/14/2017,11,-4,7
8/3/2017,8/3/2017,8/10/2017,7,0,7
8/3/2017,8/3/2017,8/10/2017,7,0,7
8/3/2017,8/3/2017,8/10/2017,7,0,7
8/10/2017,8/10/2017,9/11/2017,32,0,32
8/11/2017,8/11/2017,8/18/2017,7,0,7
8/11/2017,8/11/2017,8/18/2017,7,0,7
9/21/2015,9/21/2015,11/2/2015,42,0,42
9/21/2015,9/21/2015,11/2/2015,42,0,42
9/21/2015,9/21/2015,9/28/2015,7,0,7
9/21/2015,9/21/2015,9/28/2015,7,0,7
9/24/2015,9/22/2015,10/26/2015,34,-2,32
9/23/2015,9/23/2015,9/30/2015,7,0,7
9/23/2015,9/23/2015,9/30/2015,7,0,7
9/24/2015,9/24/2015,11/24/2015,61,0,61
9/28/2015,9/28/2015,11/16/2015,49,0,49
9/28/2015,9/28/2015,11/23/2015,56,0,56
9/30/2015,9/30/2015,11/30/2015,61,0,61
9/30/2015,9/30/2015,12/30/2015,91,0,91
9/30/2015,9/30/2015,11/5/2015,36,0,36
9/30/2015,9/30/2015,11/30/2015,61,0,61
8/16/2017,8/14/2017,8/21/2017,7,-2,5
8/14/2017,8/14/2017,8/21/2017,7,0,7
3/27/2017,3/27/2017,6/26/2017,91,0,91
3/31/2017,3/29/2017,4/28/2017,30,-2,28
3/29/2017,3/29/2017,4/5/2017,7,0,7
3/29/2017,3/29/2017,4/5/2017,7,0,7
5/16/2017,5/16/2017,5/23/2017,7,0,7
5/16/2017,5/16/2017,5/23/2017,7,0,7
5/16/2017,5/16/2017,5/23/2017,7,0,7
6/27/2017,6/27/2017,9/26/2017,91,0,91
7/18/2017,7/18/2017,10/17/2017,91,0,91
7/18/2017,7/18/2017,10/17/2017,91,0,91
7/18/2017,7/18/2017,10/16/2017,90,0,90
7/18/2017,7/18/2017,10/19/2017,93,0,93
10/28/2016,10/28/2016,11/30/2016,33,0,33
11/7/2016,11/7/2016,11/14/2016,7,0,7
11/9/2016,11/9/2016,11/16/2016,7,0,7
11/9/2016,11/9/2016,11/16/2016,7,0,7
11/9/2016,11/9/2016,11/16/2016,7,0,7
11/9/2016,11/9/2016,11/16/2016,7,0,7
12/19/2016,11/9/2016,2/14/2017,97,-40,57
11/14/2016,11/9/2016,12/14/2016,35,-5,30
11/29/2016,11/29/2016,12/29/2016,30,0,30
11/29/2016,11/29/2016,12/30/2016,31,0,31
11/29/2016,11/29/2016,12/30/2016,31,0,31
11/29/2016,11/29/2016,12/30/2016,31,0,31
2/22/2017,2/22/2017,3/1/2017,7,0,7
2/27/2017,2/23/2017,3/27/2017,32,-4,28
2/24/2017,2/24/2017,3/3/2017,7,0,7
6/19/2017,6/19/2017,7/19/2017,30,0,30
6/20/2017,6/19/2017,8/21/2017,63,-1,62
6/20/2017,6/20/2017,8/21/2017,62,0,62
6/20/2017,6/20/2017,8/21/2017,62,0,62
6/21/2017,6/20/2017,9/22/2017,94,-1,93
3/23/2016,3/23/2016,3/31/2016,8,0,8
3/23/2016,3/23/2016,3/31/2016,8,0,8
11/30/2016,11/30/2016,12/7/2016,7,0,7
11/30/2016,11/30/2016,12/7/2016,7,0,7
11/30/2016,11/30/2016,12/7/2016,7,0,7
1/26/2017,1/26/2017,2/2/2017,7,0,7
1/26/2017,1/26/2017,2/2/2017,7,0,7
1/27/2017,1/27/2017,2/3/2017,7,0,7
1/27/2017,1/27/2017,2/3/2017,7,0,7
2/23/2017,2/23/2017,3/2/2017,7,0,7
2/28/2017,2/24/2017,3/31/2017,35,-4,31
5/15/2017,5/15/2017,8/16/2017,93,0,93
5/18/2017,5/18/2017,6/19/2017,32,0,32
5/23/2017,5/19/2017,8/23/2017,96,-4,92
5/23/2017,5/19/2017,6/23/2017,35,-4,31
5/22/2017,5/19/2017,6/22/2017,34,-3,31
5/19/2017,5/19/2017,5/26/2017,7,0,7
6/12/2017,6/12/2017,7/12/2017,30,0,30
6/12/2017,6/12/2017,7/12/2017,30,0,30
6/12/2017,6/12/2017,7/12/2017,30,0,30
6/12/2017,6/12/2017,6/19/2017,7,0,7
6/12/2017,6/12/2017,9/12/2017,92,0,92
5/18/2016,5/18/2016,8/18/2016,92,0,92
5/18/2016,5/18/2016,8/18/2016,92,0,92
5/19/2016,5/19/2016,5/26/2016,7,0,7
5/19/2016,5/19/2016,5/26/2016,7,0,7
5/19/2016,5/19/2016,5/26/2016,7,0,7
9/28/2016,9/28/2016,10/5/2016,7,0,7
9/28/2016,9/28/2016,10/5/2016,7,0,7
9/28/2016,9/28/2016,12/28/2016,91,0,91
9/29/2016,9/28/2016,12/28/2016,91,-1,90
7/10/2017,7/10/2017,10/10/2017,92,0,92
7/10/2017,7/10/2017,7/18/2017,8,0,8
7/11/2017,7/10/2017,8/14/2017,35,-1,34
7/30/2015,7/30/2015,7/31/2015,1,0,1
7/30/2015,7/30/2015,7/31/2015,1,0,1
7/30/2015,7/30/2015,7/31/2015,1,0,1
8/5/2015,8/3/2015,8/12/2015,9,-2,7
8/5/2015,8/3/2015,11/5/2015,94,-2,92
8/3/2015,8/3/2015,9/10/2015,38,0,38
8/3/2015,8/3/2015,9/3/2015,31,0,31
8/3/2015,8/3/2015,8/10/2015,7,0,7
8/3/2015,8/3/2015,8/10/2015,7,0,7
8/3/2015,8/3/2015,10/2/2015,60,0,60
8/4/2015,8/4/2015,9/8/2015,35,0,35
8/4/2015,8/4/2015,8/11/2015,7,0,7
8/4/2015,8/4/2015,8/5/2015,1,0,1
8/4/2015,8/4/2015,8/5/2015,1,0,1
8/4/2015,8/4/2015,10/5/2015,62,0,62
8/5/2015,8/5/2015,8/12/2015,7,0,7
8/5/2015,8/5/2015,10/6/2015,62,0,62
8/5/2015,8/5/2015,9/18/2015,44,0,44
8/10/2015,8/6/2015,9/10/2015,35,-4,31
8/10/2015,8/6/2015,9/30/2015,55,-4,51
8/10/2015,8/6/2015,9/30/2015,55,-4,51
8/10/2015,8/10/2015,8/17/2015,7,0,7
8/11/2015,8/10/2015,11/12/2015,94,-1,93
8/12/2015,8/11/2015,9/14/2015,34,-1,33
8/12/2015,8/11/2015,9/14/2015,34,-1,33
8/17/2015,8/13/2015,9/17/2015,35,-4,31
8/17/2015,8/13/2015,9/17/2015,35,-4,31
8/17/2015,8/13/2015,9/17/2015,35,-4,31
9/26/2017,9/26/2017,9/29/2017,3,0,3
7/3/2017,6/29/2017,9/4/2017,67,-4,63
7/3/2017,6/29/2017,7/10/2017,11,-4,7
6/29/2017,6/29/2017,7/31/2017,32,0,32
6/29/2017,6/29/2017,7/31/2017,32,0,32
6/29/2017,6/29/2017,7/31/2017,32,0,32
6/29/2017,6/29/2017,7/31/2017,32,0,32
6/29/2017,6/29/2017,7/31/2017,32,0,32
6/29/2017,6/29/2017,7/10/2017,11,0,11
6/30/2017,6/30/2017,7/7/2017,7,0,7
6/30/2017,6/30/2017,7/7/2017,7,0,7
4/19/2016,4/18/2016,4/27/2016,9,-1,8
4/19/2016,4/19/2016,4/26/2016,7,0,7
4/19/2016,4/19/2016,4/26/2016,7,0,7
6/7/2017,6/6/2017,9/8/2017,94,-1,93
6/6/2017,6/6/2017,9/6/2017,92,0,92
6/6/2017,6/6/2017,9/6/2017,92,0,92
6/6/2017,6/6/2017,9/6/2017,92,0,92
6/6/2017,6/6/2017,9/19/2017,105,0,105
6/8/2017,6/8/2017,7/10/2017,32,0,32
6/13/2017,6/9/2017,8/14/2017,66,-4,62
7/5/2017,7/5/2017,8/4/2017,30,0,30
7/5/2017,7/5/2017,8/4/2017,30,0,30
7/26/2017,7/24/2017,8/28/2017,35,-2,33
7/26/2017,7/24/2017,8/28/2017,35,-2,33
7/25/2017,7/25/2017,8/28/2017,34,0,34
7/25/2017,7/25/2017,10/24/2017,91,0,91
7/25/2017,7/25/2017,10/24/2017,91,0,91
8/18/2015,8/18/2015,8/25/2015,7,0,7
8/20/2015,8/18/2015,9/21/2015,34,-2,32
8/20/2015,8/18/2015,11/20/2015,94,-2,92
12/8/2015,12/8/2015,2/2/2016,56,0,56
12/8/2015,12/8/2015,12/15/2015,7,0,7
12/8/2015,12/8/2015,2/5/2016,59,0,59
4/10/2017,4/10/2017,5/10/2017,30,0,30
4/11/2017,4/11/2017,5/11/2017,30,0,30
4/11/2017,4/11/2017,5/11/2017,30,0,30
4/11/2017,4/11/2017,7/11/2017,91,0,91
5/23/2017,5/18/2017,5/30/2017,12,-5,7
5/23/2017,5/22/2017,6/1/2017,10,-1,9
12/2/2015,11/30/2015,2/2/2016,64,-2,62
12/2/2015,11/30/2015,12/9/2015,9,-2,7
12/2/2015,11/30/2015,1/4/2016,35,-2,33
12/1/2015,12/1/2015,3/3/2016,93,0,93
12/2/2015,12/2/2015,12/9/2015,7,0,7
12/2/2015,12/2/2015,3/3/2016,92,0,92
12/2/2015,12/2/2015,3/4/2016,93,0,93
12/3/2015,12/3/2015,2/4/2016,63,0,63
12/3/2015,12/3/2015,2/4/2016,63,0,63
12/4/2015,12/3/2015,12/11/2015,8,-1,7
12/9/2015,12/7/2015,1/11/2016,35,-2,33
12/9/2015,12/7/2015,3/9/2016,93,-2,91
12/9/2015,12/7/2015,3/9/2016,93,-2,91
12/7/2015,12/7/2015,3/7/2016,91,0,91
12/7/2015,12/7/2015,12/8/2015,1,0,1
12/7/2015,12/7/2015,12/8/2015,1,0,1
12/7/2015,12/7/2015,12/8/2015,1,0,1
12/7/2015,12/7/2015,1/7/2016,31,0,31
12/7/2015,12/7/2015,3/4/2016,88,0,88
12/29/2015,12/29/2015,1/5/2016,7,0,7
12/29/2015,12/29/2015,1/5/2016,7,0,7
12/29/2015,12/29/2015,1/5/2016,7,0,7
12/31/2015,12/31/2015,3/30/2016,90,0,90
12/31/2015,12/31/2015,1/7/2016,7,0,7
12/31/2015,12/31/2015,1/7/2016,7,0,7
12/31/2015,12/31/2015,1/7/2016,7,0,7
12/31/2015,12/31/2015,1/7/2016,7,0,7
1/5/2016,1/5/2016,1/12/2016,7,0,7
5/18/2017,5/18/2017,5/25/2017,7,0,7
5/18/2017,5/18/2017,8/17/2017,91,0,91
6/9/2017,6/9/2017,9/8/2017,91,0,91
6/9/2017,6/9/2017,6/16/2017,7,0,7
6/12/2017,6/9/2017,6/16/2017,7,-3,4
7/31/2017,7/31/2017,8/7/2017,7,0,7
7/31/2017,7/31/2017,8/7/2017,7,0,7
7/31/2017,7/31/2017,9/1/2017,32,0,32
10/1/2015,10/1/2015,11/2/2015,32,0,32
10/2/2015,10/2/2015,12/2/2015,61,0,61
10/2/2015,10/2/2015,10/9/2015,7,0,7
10/2/2015,10/2/2015,10/9/2015,7,0,7
10/7/2015,10/5/2015,10/14/2015,9,-2,7
3/23/2016,3/23/2016,3/30/2016,7,0,7
4/4/2016,3/23/2016,4/29/2016,37,-12,25
3/29/2016,3/23/2016,4/29/2016,37,-6,31
4/11/2016,4/11/2016,4/18/2016,7,0,7
4/11/2016,4/11/2016,4/18/2016,7,0,7
4/11/2016,4/11/2016,4/18/2016,7,0,7
3/13/2017,3/13/2017,6/13/2017,92,0,92
3/13/2017,3/13/2017,4/13/2017,31,0,31
3/13/2017,3/13/2017,6/9/2017,88,0,88
3/13/2017,3/13/2017,6/12/2017,91,0,91
3/14/2017,3/14/2017,6/14/2017,92,0,92
3/14/2017,3/14/2017,4/18/2017,35,0,35
3/14/2017,3/14/2017,6/14/2017,92,0,92
3/21/2017,3/21/2017,6/21/2017,92,0,92
3/22/2017,3/21/2017,6/23/2017,94,-1,93
3/22/2017,3/21/2017,4/24/2017,34,-1,33
3/22/2017,3/22/2017,3/29/2017,7,0,7
3/22/2017,3/22/2017,3/29/2017,7,0,7
3/27/2017,3/23/2017,4/27/2017,35,-4,31
3/27/2017,3/23/2017,4/27/2017,35,-4,31
8/21/2017,8/21/2017,8/25/2017,4,0,4
8/21/2017,8/21/2017,8/25/2017,4,0,4
1/6/2016,1/6/2016,1/13/2016,7,0,7
1/6/2016,1/6/2016,1/13/2016,7,0,7
1/6/2016,1/6/2016,4/5/2016,90,0,90
1/8/2016,1/7/2016,2/11/2016,35,-1,34
1/8/2016,1/7/2016,2/11/2016,35,-1,34
1/8/2016,1/8/2016,1/19/2016,11,0,11
1/14/2016,1/12/2016,2/15/2016,34,-2,32
1/14/2016,1/12/2016,2/15/2016,34,-2,32
1/13/2016,1/13/2016,1/20/2016,7,0,7
1/13/2016,1/13/2016,1/20/2016,7,0,7
1/14/2016,1/14/2016,1/21/2016,7,0,7
1/14/2016,1/14/2016,1/21/2016,7,0,7
1/18/2016,1/14/2016,2/18/2016,35,-4,31
1/21/2016,1/19/2016,4/21/2016,93,-2,91
1/19/2016,1/19/2016,1/26/2016,7,0,7
1/20/2016,1/20/2016,1/27/2016,7,0,7
1/29/2016,1/28/2016,4/1/2016,64,-1,63
2/3/2016,2/1/2016,2/10/2016,9,-2,7
2/2/2016,2/2/2016,2/9/2016,7,0,7
2/10/2016,2/8/2016,2/17/2016,9,-2,7
2/11/2016,2/9/2016,3/11/2016,31,-2,29
2/10/2016,2/10/2016,5/10/2016,90,0,90
2/10/2016,2/10/2016,2/16/2016,6,0,6
2/11/2016,2/11/2016,2/18/2016,7,0,7
2/11/2016,2/11/2016,2/18/2016,7,0,7
2/11/2016,2/11/2016,2/18/2016,7,0,7
3/9/2016,3/7/2016,3/16/2016,9,-2,7
3/9/2016,3/7/2016,6/9/2016,94,-2,92
3/8/2016,3/7/2016,6/8/2016,93,-1,92
1/7/2015,1/5/2015,2/9/2015,35,-2,33
9/27/2016,9/27/2016,10/4/2016,7,0,7
9/27/2016,9/27/2016,10/4/2016,7,0,7
9/28/2016,9/28/2016,10/31/2016,33,0,33
9/30/2016,9/28/2016,10/31/2016,33,-2,31
9/28/2016,9/28/2016,10/31/2016,33,0,33
9/28/2016,9/28/2016,10/31/2016,33,0,33
11/4/2016,11/4/2016,2/6/2017,94,0,94
11/4/2016,11/4/2016,2/2/2017,90,0,90
11/4/2016,11/4/2016,12/7/2016,33,0,33
11/4/2016,11/4/2016,2/6/2017,94,0,94
11/4/2016,11/4/2016,11/14/2016,10,0,10
11/4/2016,11/4/2016,11/14/2016,10,0,10
11/4/2016,11/4/2016,2/8/2017,96,0,96
11/8/2016,11/7/2016,1/9/2017,63,-1,62
6/21/2017,6/19/2017,9/21/2017,94,-2,92
6/19/2017,6/19/2017,6/26/2017,7,0,7
6/22/2017,6/20/2017,7/24/2017,34,-2,32
7/10/2017,7/6/2017,9/11/2017,67,-4,63
7/20/2015,7/20/2015,10/20/2015,92,0,92
7/20/2015,7/20/2015,8/20/2015,31,0,31
7/20/2015,7/20/2015,7/27/2015,7,0,7
7/27/2015,7/23/2015,9/28/2015,67,-4,63
7/23/2015,7/23/2015,7/29/2015,6,0,6
7/23/2015,7/23/2015,7/30/2015,7,0,7
7/23/2015,7/23/2015,7/30/2015,7,0,7
7/24/2015,7/24/2015,7/31/2015,7,0,7
7/24/2015,7/24/2015,7/31/2015,7,0,7
2/29/2016,2/29/2016,6/1/2016,93,0,93
3/1/2016,3/1/2016,3/8/2016,7,0,7
3/1/2016,3/1/2016,3/8/2016,7,0,7
3/1/2016,3/1/2016,3/8/2016,7,0,7
4/6/2016,4/4/2016,4/13/2016,9,-2,7
4/5/2016,4/5/2016,4/12/2016,7,0,7
4/5/2016,4/5/2016,4/12/2016,7,0,7
4/5/2016,4/5/2016,7/5/2016,91,0,91
7/5/2016,7/5/2016,7/13/2016,8,0,8
7/5/2016,7/5/2016,7/12/2016,7,0,7
7/5/2016,7/5/2016,10/5/2016,92,0,92
8/2/2016,7/29/2016,11/2/2016,96,-4,92
8/2/2016,7/29/2016,11/2/2016,96,-4,92
8/29/2016,8/29/2016,9/30/2016,32,0,32
8/29/2016,8/29/2016,9/30/2016,32,0,32
8/29/2016,8/29/2016,9/30/2016,32,0,32
6/29/2017,6/29/2017,7/31/2017,32,0,32
6/30/2017,6/29/2017,7/31/2017,32,-1,31
6/29/2017,6/29/2017,7/31/2017,32,0,32
6/30/2017,6/30/2017,8/30/2017,61,0,61
6/30/2017,6/30/2017,7/28/2017,28,0,28
7/13/2017,7/13/2017,7/20/2017,7,0,7
7/13/2017,7/13/2017,7/20/2017,7,0,7
7/13/2017,7/13/2017,7/20/2017,7,0,7
7/13/2017,7/13/2017,10/12/2017,91,0,91
4/2/2015,4/2/2015,4/10/2015,8,0,8
4/7/2015,4/7/2015,6/8/2015,62,0,62
4/7/2015,4/7/2015,5/7/2015,30,0,30
4/8/2015,4/8/2015,5/8/2015,30,0,30
4/13/2015,4/9/2015,5/7/2015,28,-4,24
4/14/2015,4/10/2015,4/21/2015,11,-4,7
4/10/2015,4/10/2015,4/17/2015,7,0,7
4/10/2015,4/10/2015,4/17/2015,7,0,7
4/13/2015,4/13/2015,4/20/2015,7,0,7
4/13/2015,4/13/2015,4/20/2015,7,0,7
4/20/2015,4/20/2015,5/20/2015,30,0,30
4/20/2015,4/20/2015,5/20/2015,30,0,30
4/20/2015,4/20/2015,4/27/2015,7,0,7
4/24/2015,4/22/2015,6/24/2015,63,-2,61
4/24/2015,4/22/2015,5/26/2015,34,-2,32
4/24/2015,4/22/2015,5/26/2015,34,-2,32
5/27/2015,5/27/2015,6/25/2015,29,0,29
5/27/2015,5/27/2015,6/3/2015,7,0,7
5/27/2015,5/27/2015,6/3/2015,7,0,7
6/1/2015,5/28/2015,6/8/2015,11,-4,7
11/6/2015,11/5/2015,11/13/2015,8,-1,7
11/9/2015,11/9/2015,2/9/2016,92,0,92
11/18/2015,11/16/2015,11/25/2015,9,-2,7
11/17/2015,11/17/2015,11/24/2015,7,0,7
11/23/2015,11/19/2015,12/23/2015,34,-4,30
11/23/2015,11/19/2015,12/23/2015,34,-4,30
11/23/2015,11/19/2015,2/23/2016,96,-4,92
11/23/2015,11/20/2015,11/25/2015,5,-3,2
11/20/2015,11/20/2015,11/27/2015,7,0,7
10/26/2016,10/26/2016,11/2/2016,7,0,7
10/26/2016,10/26/2016,11/2/2016,7,0,7
10/26/2016,10/26/2016,11/2/2016,7,0,7
5/31/2017,5/31/2017,6/30/2017,30,0,30
5/31/2017,5/31/2017,7/31/2017,61,0,61
5/31/2017,5/31/2017,6/12/2017,12,0,12
5/31/2017,5/31/2017,6/12/2017,12,0,12
5/31/2017,5/31/2017,6/12/2017,12,0,12
4/22/2016,4/20/2016,6/22/2016,63,-2,61
4/26/2016,4/26/2016,6/28/2016,63,0,63
4/26/2016,4/26/2016,5/3/2016,7,0,7
4/27/2016,4/26/2016,5/31/2016,35,-1,34
4/26/2016,4/26/2016,5/31/2016,35,0,35
4/26/2016,4/26/2016,5/31/2016,35,0,35
7/13/2016,7/13/2016,7/20/2016,7,0,7
7/13/2016,7/13/2016,7/20/2016,7,0,7
7/13/2016,7/13/2016,8/12/2016,30,0,30
7/18/2016,7/14/2016,8/18/2016,35,-4,31
7/20/2016,7/18/2016,8/22/2016,35,-2,33
7/20/2016,7/18/2016,8/22/2016,35,-2,33
7/20/2016,7/18/2016,7/27/2016,9,-2,7
7/18/2016,7/18/2016,8/18/2016,31,0,31
7/18/2016,7/18/2016,7/26/2016,8,0,8
7/19/2016,7/19/2016,7/26/2016,7,0,7
8/29/2016,8/29/2016,9/30/2016,32,0,32
8/29/2016,8/29/2016,9/30/2016,32,0,32
8/29/2016,8/29/2016,9/30/2016,32,0,32
8/30/2016,8/30/2016,9/6/2016,7,0,7
8/30/2016,8/30/2016,9/6/2016,7,0,7
10/12/2016,10/10/2016,10/19/2016,9,-2,7
10/12/2016,10/10/2016,12/12/2016,63,-2,61
10/11/2016,10/11/2016,1/11/2017,92,0,92
10/11/2016,10/11/2016,11/14/2016,34,0,34
10/11/2016,10/11/2016,10/18/2016,7,0,7
10/11/2016,10/11/2016,10/18/2016,7,0,7
10/11/2016,10/11/2016,10/18/2016,7,0,7
2/27/2015,2/27/2015,3/27/2015,28,0,28
2/27/2015,2/27/2015,4/28/2015,60,0,60
2/27/2015,2/27/2015,3/6/2015,7,0,7
2/27/2015,2/27/2015,3/6/2015,7,0,7
3/5/2015,3/3/2015,4/7/2015,35,-2,33
3/12/2015,3/10/2015,6/12/2015,94,-2,92
3/12/2015,3/10/2015,4/13/2015,34,-2,32
6/1/2015,6/1/2015,6/8/2015,7,0,7
6/5/2015,6/5/2015,6/8/2015,3,0,3
6/5/2015,6/5/2015,6/30/2015,25,0,25
6/9/2015,6/8/2015,7/9/2015,31,-1,30
6/18/2015,6/18/2015,7/20/2015,32,0,32
6/24/2015,6/18/2015,7/1/2015,13,-6,7
7/31/2015,7/31/2015,8/7/2015,7,0,7
7/31/2015,7/31/2015,8/31/2015,31,0,31
7/31/2015,7/31/2015,8/3/2015,3,0,3
8/5/2015,8/4/2015,9/7/2015,34,-1,33
8/11/2015,8/11/2015,11/12/2015,93,0,93
8/11/2015,8/11/2015,8/12/2015,1,0,1
8/11/2015,8/11/2015,8/12/2015,1,0,1
8/11/2015,8/11/2015,8/12/2015,1,0,1
8/11/2015,8/11/2015,8/18/2015,7,0,7
8/11/2015,8/11/2015,8/18/2015,7,0,7
8/11/2015,8/11/2015,8/19/2015,8,0,8
8/14/2015,8/12/2015,8/21/2015,9,-2,7
8/17/2015,8/17/2015,8/24/2015,7,0,7
8/17/2015,8/17/2015,8/24/2015,7,0,7
10/23/2015,10/23/2015,10/30/2015,7,0,7
10/23/2015,10/23/2015,10/30/2015,7,0,7
11/20/2015,11/20/2015,11/27/2015,7,0,7
1/30/2015,1/29/2015,3/2/2015,32,-1,31
2/2/2015,1/30/2015,4/7/2015,67,-3,64
2/4/2015,2/3/2015,3/5/2015,30,-1,29
2/4/2015,2/3/2015,3/5/2015,30,-1,29
2/9/2015,2/5/2015,3/9/2015,32,-4,28
2/9/2015,2/5/2015,3/9/2015,32,-4,28
2/9/2015,2/5/2015,2/16/2015,11,-4,7
2/6/2015,2/6/2015,5/8/2015,91,0,91
2/6/2015,2/6/2015,5/8/2015,91,0,91
2/6/2015,2/6/2015,3/6/2015,28,0,28
2/6/2015,2/6/2015,3/9/2015,31,0,31
2/11/2015,2/10/2015,5/15/2015,94,-1,93
2/16/2015,2/16/2015,3/17/2015,29,0,29
2/17/2015,2/17/2015,3/17/2015,28,0,28
2/17/2015,2/17/2015,2/24/2015,7,0,7
2/20/2015,2/19/2015,4/24/2015,64,-1,63
2/20/2015,2/19/2015,3/2/2015,11,-1,10
2/25/2015,2/25/2015,3/4/2015,7,0,7
2/26/2015,2/26/2015,3/2/2015,4,0,4
3/9/2015,3/9/2015,6/9/2015,92,0,92
3/16/2015,3/12/2015,6/16/2015,96,-4,92
3/17/2015,3/13/2015,4/17/2015,35,-4,31
3/13/2015,3/13/2015,3/20/2015,7,0,7
2/25/2016,2/25/2016,3/3/2016,7,0,7
2/25/2016,2/25/2016,3/3/2016,7,0,7
3/1/2016,2/26/2016,4/1/2016,35,-4,31
3/15/2016,3/15/2016,3/23/2016,8,0,8
8/30/2016,8/30/2016,9/6/2016,7,0,7
8/30/2016,8/30/2016,9/7/2016,8,0,8
9/14/2016,9/14/2016,9/21/2016,7,0,7
9/19/2016,9/19/2016,10/19/2016,30,0,30
9/19/2016,9/19/2016,10/25/2016,36,0,36
9/22/2016,9/20/2016,10/24/2016,34,-2,32
10/5/2016,10/3/2016,10/12/2016,9,-2,7
10/4/2016,10/4/2016,11/4/2016,31,0,31
10/4/2016,10/4/2016,10/11/2016,7,0,7
10/7/2016,10/5/2016,11/7/2016,33,-2,31
10/10/2016,10/6/2016,12/12/2016,67,-4,63
10/6/2016,10/6/2016,10/13/2016,7,0,7
10/6/2016,10/6/2016,10/13/2016,7,0,7
10/11/2016,10/7/2016,12/12/2016,66,-4,62
11/2/2016,11/2/2016,11/9/2016,7,0,7
11/2/2016,11/2/2016,11/9/2016,7,0,7
11/2/2016,11/2/2016,11/9/2016,7,0,7
11/2/2016,11/2/2016,11/9/2016,7,0,7
11/3/2016,11/3/2016,2/3/2017,92,0,92
7/27/2015,7/27/2015,7/31/2015,4,0,4
7/29/2015,7/27/2015,8/31/2015,35,-2,33
7/29/2015,7/27/2015,8/31/2015,35,-2,33
7/29/2015,7/27/2015,8/5/2015,9,-2,7
7/30/2015,7/28/2015,8/31/2015,34,-2,32
7/29/2015,7/29/2015,8/5/2015,7,0,7
7/29/2015,7/29/2015,8/5/2015,7,0,7
7/29/2015,7/29/2015,8/5/2015,7,0,7
7/29/2015,7/29/2015,9/1/2015,34,0,34
11/23/2015,11/20/2015,11/27/2015,7,-3,4
11/25/2015,11/23/2015,12/2/2015,9,-2,7
11/25/2015,11/25/2015,12/2/2015,7,0,7
11/25/2015,11/25/2015,12/2/2015,7,0,7
11/30/2015,11/26/2015,12/30/2015,34,-4,30
11/30/2015,11/26/2015,12/24/2015,28,-4,24
11/30/2015,11/27/2015,3/3/2016,97,-3,94
11/26/2015,11/26/2015,3/3/2016,98,0,98
11/27/2015,11/27/2015,12/4/2015,7,0,7
11/30/2015,11/30/2015,2/1/2016,63,0,63
12/10/2015,12/8/2015,3/8/2016,91,-2,89
12/10/2015,12/8/2015,1/11/2016,34,-2,32
1/5/2016,1/4/2016,1/13/2016,9,-1,8
1/6/2016,1/5/2016,2/8/2016,34,-1,33
1/12/2016,1/12/2016,1/19/2016,7,0,7
1/12/2016,1/12/2016,1/19/2016,7,0,7
1/12/2016,1/12/2016,4/12/2016,91,0,91
1/12/2016,1/12/2016,4/12/2016,91,0,91
2/22/2016,2/22/2016,5/27/2016,95,0,95
3/8/2016,3/8/2016,3/15/2016,7,0,7
3/8/2016,3/8/2016,3/15/2016,7,0,7
8/17/2016,8/17/2016,8/24/2016,7,0,7
7/6/2017,7/6/2017,8/7/2017,32,0,32
7/7/2017,7/7/2017,7/13/2017,6,0,6
7/7/2017,7/7/2017,7/13/2017,6,0,6
7/7/2017,7/7/2017,7/17/2017,10,0,10
4/28/2015,4/27/2015,6/10/2015,44,-1,43
4/29/2015,4/28/2015,5/29/2015,31,-1,30
4/29/2015,4/28/2015,5/29/2015,31,-1,30
4/28/2015,4/28/2015,5/6/2015,8,0,8
6/19/2015,6/19/2015,6/26/2015,7,0,7
6/22/2015,6/22/2015,6/29/2015,7,0,7
6/22/2015,6/22/2015,6/29/2015,7,0,7
6/22/2015,6/22/2015,6/29/2015,7,0,7
6/29/2015,6/23/2015,7/29/2015,36,-6,30
6/24/2015,6/23/2015,9/24/2015,93,-1,92
6/26/2015,6/24/2015,7/27/2015,33,-2,31
6/24/2015,6/24/2015,7/1/2015,7,0,7
6/24/2015,6/24/2015,8/3/2015,40,0,40
6/26/2015,6/24/2015,7/27/2015,33,-2,31
6/25/2015,6/24/2015,8/3/2015,40,-1,39
6/25/2015,6/25/2015,7/2/2015,7,0,7
6/25/2015,6/25/2015,8/4/2015,40,0,40
6/30/2015,6/25/2015,8/5/2015,41,-5,36
6/26/2015,6/25/2015,7/31/2015,36,-1,35
7/6/2015,7/6/2015,7/13/2015,7,0,7
7/9/2015,7/7/2015,8/10/2015,34,-2,32
7/8/2015,7/8/2015,7/15/2015,7,0,7
7/8/2015,7/8/2015,7/15/2015,7,0,7
9/21/2015,9/17/2015,12/21/2015,95,-4,91
1/30/2015,1/30/2015,3/11/2015,40,0,40
2/2/2015,1/30/2015,3/11/2015,40,-3,37
2/3/2015,2/3/2015,5/5/2015,91,0,91
2/3/2015,2/3/2015,5/5/2015,91,0,91
2/3/2015,2/3/2015,3/3/2015,28,0,28
2/4/2015,2/4/2015,5/5/2015,90,0,90
2/13/2015,2/12/2015,2/23/2015,11,-1,10
2/13/2015,2/12/2015,3/16/2015,32,-1,31
2/19/2015,2/19/2015,4/20/2015,60,0,60
2/20/2015,2/20/2015,2/27/2015,7,0,7
3/2/2015,3/2/2015,4/7/2015,36,0,36
3/2/2015,3/2/2015,4/7/2015,36,0,36
3/9/2015,3/9/2015,3/19/2015,10,0,10
3/11/2015,3/10/2015,4/13/2015,34,-1,33
3/11/2015,3/11/2015,3/18/2015,7,0,7
3/12/2015,3/12/2015,3/13/2015,1,0,1
7/2/2015,7/2/2015,7/9/2015,7,0,7
7/2/2015,7/2/2015,7/9/2015,7,0,7
7/2/2015,7/2/2015,7/9/2015,7,0,7
7/15/2015,7/10/2015,7/22/2015,12,-5,7
7/15/2015,7/13/2015,9/15/2015,64,-2,62
12/30/2015,12/30/2015,1/6/2016,7,0,7
12/30/2015,12/30/2015,1/6/2016,7,0,7
12/30/2015,12/30/2015,1/6/2016,7,0,7
1/4/2016,1/4/2016,1/11/2016,7,0,7
3/4/2015,3/3/2015,6/4/2015,93,-1,92
3/3/2015,3/3/2015,6/3/2015,92,0,92
3/3/2015,3/3/2015,4/8/2015,36,0,36
3/4/2015,3/4/2015,6/5/2015,93,0,93
3/9/2015,3/5/2015,6/9/2015,96,-4,92
3/9/2015,3/5/2015,3/16/2015,11,-4,7
3/9/2015,3/5/2015,4/9/2015,35,-4,31
3/6/2015,3/6/2015,3/13/2015,7,0,7
3/6/2015,3/6/2015,3/13/2015,7,0,7
3/6/2015,3/6/2015,3/13/2015,7,0,7
3/9/2015,3/9/2015,6/9/2015,92,0,92
3/9/2015,3/9/2015,6/9/2015,92,0,92
3/9/2015,3/9/2015,4/9/2015,31,0,31
3/9/2015,3/9/2015,4/9/2015,31,0,31
3/9/2015,3/9/2015,6/10/2015,93,0,93
3/9/2015,3/9/2015,3/10/2015,1,0,1
3/10/2015,3/10/2015,3/17/2015,7,0,7
3/11/2015,3/11/2015,4/13/2015,33,0,33
4/14/2015,4/14/2015,4/21/2015,7,0,7
4/21/2015,4/21/2015,4/28/2015,7,0,7
4/21/2015,4/21/2015,4/28/2015,7,0,7
4/24/2015,4/21/2015,5/29/2015,38,-3,35
5/29/2015,5/29/2015,6/29/2015,31,0,31
6/4/2015,6/2/2015,7/6/2015,34,-2,32
6/4/2015,6/4/2015,6/30/2015,26,0,26
6/4/2015,6/4/2015,6/30/2015,26,0,26
6/8/2015,6/4/2015,8/10/2015,67,-4,63
6/8/2015,6/4/2015,6/15/2015,11,-4,7
6/8/2015,6/4/2015,7/8/2015,34,-4,30
7/1/2015,7/1/2015,7/8/2015,7,0,7
7/1/2015,7/1/2015,7/8/2015,7,0,7
7/1/2015,7/1/2015,7/8/2015,7,0,7
7/8/2015,7/6/2015,7/15/2015,9,-2,7
7/10/2015,7/8/2015,7/15/2015,7,-2,5
7/10/2015,7/8/2015,9/10/2015,64,-2,62
7/10/2015,7/9/2015,8/10/2015,32,-1,31
7/13/2015,7/9/2015,8/13/2015,35,-4,31
7/13/2015,7/9/2015,8/13/2015,35,-4,31
7/10/2015,7/10/2015,7/17/2015,7,0,7
7/10/2015,7/10/2015,7/17/2015,7,0,7
7/10/2015,7/10/2015,7/17/2015,7,0,7
7/10/2015,7/10/2015,7/20/2015,10,0,10
7/15/2015,7/15/2015,7/22/2015,7,0,7
7/15/2015,7/15/2015,7/22/2015,7,0,7
7/20/2015,7/16/2015,8/20/2015,35,-4,31
7/20/2015,7/16/2015,9/21/2015,67,-4,63
7/20/2015,7/16/2015,9/21/2015,67,-4,63
1/7/2016,1/7/2016,4/7/2016,91,0,91
1/7/2016,1/7/2016,1/14/2016,7,0,7
1/7/2016,1/7/2016,1/14/2016,7,0,7
1/7/2016,1/7/2016,1/14/2016,7,0,7
1/13/2016,1/11/2016,1/20/2016,9,-2,7
3/8/2016,3/8/2016,3/15/2016,7,0,7
3/10/2016,3/8/2016,6/10/2016,94,-2,92
10/26/2016,10/26/2016,11/2/2016,7,0,7
9/21/2015,9/17/2015,11/23/2015,67,-4,63
9/18/2015,9/18/2015,9/25/2015,7,0,7
9/18/2015,9/18/2015,12/18/2015,91,0,91
9/18/2015,9/18/2015,11/16/2015,59,0,59
9/22/2015,9/22/2015,9/29/2015,7,0,7
9/23/2015,9/23/2015,12/23/2015,91,0,91
9/24/2015,9/24/2015,11/2/2015,39,0,39
9/25/2015,9/25/2015,11/4/2015,40,0,40
9/25/2015,9/25/2015,11/4/2015,40,0,40
9/25/2015,9/25/2015,10/2/2015,7,0,7
9/25/2015,9/25/2015,9/30/2015,5,0,5
5/17/2016,5/3/2016,8/3/2016,92,-14,78
5/18/2016,5/16/2016,5/25/2016,9,-2,7
5/16/2016,5/16/2016,5/23/2016,7,0,7
5/17/2016,5/17/2016,5/24/2016,7,0,7
5/17/2016,5/17/2016,5/24/2016,7,0,7
5/17/2016,5/17/2016,5/24/2016,7,0,7
5/23/2016,5/19/2016,6/23/2016,35,-4,31
5/23/2016,5/19/2016,6/17/2016,29,-4,25
5/20/2016,5/20/2016,5/27/2016,7,0,7
5/20/2016,5/20/2016,5/27/2016,7,0,7
5/24/2016,5/24/2016,8/24/2016,92,0,92
5/24/2016,5/24/2016,5/31/2016,7,0,7
5/24/2016,5/24/2016,5/31/2016,7,0,7
5/24/2016,5/24/2016,6/23/2016,30,0,30
8/31/2016,8/31/2016,9/7/2016,7,0,7
9/21/2016,9/21/2016,9/28/2016,7,0,7
3/15/2016,3/14/2016,3/23/2016,9,-1,8
3/15/2016,3/14/2016,4/18/2016,35,-1,34
3/14/2016,3/14/2016,3/22/2016,8,0,8
3/16/2016,3/16/2016,3/23/2016,7,0,7
3/16/2016,3/16/2016,3/23/2016,7,0,7
3/16/2016,3/16/2016,3/23/2016,7,0,7
3/16/2016,3/16/2016,4/18/2016,33,0,33
3/30/2016,3/29/2016,4/6/2016,8,-1,7
4/4/2016,4/1/2016,5/6/2016,35,-3,32
4/21/2016,4/21/2016,7/21/2016,91,0,91
4/21/2016,4/21/2016,7/21/2016,91,0,91
4/21/2016,4/21/2016,4/28/2016,7,0,7
4/25/2016,4/21/2016,6/27/2016,67,-4,63
4/22/2016,4/22/2016,4/29/2016,7,0,7
4/22/2016,4/22/2016,4/25/2016,3,0,3
5/4/2016,5/4/2016,8/2/2016,90,0,90
5/11/2016,5/9/2016,5/18/2016,9,-2,7
5/11/2016,5/9/2016,6/13/2016,35,-2,33
5/10/2016,5/10/2016,5/17/2016,7,0,7
5/10/2016,5/10/2016,5/17/2016,7,0,7
5/10/2016,5/10/2016,5/17/2016,7,0,7
6/10/2016,6/8/2016,9/12/2016,96,-2,94
6/10/2016,6/8/2016,8/10/2016,63,-2,61
6/14/2016,6/10/2016,9/14/2016,96,-4,92
6/15/2016,6/13/2016,6/22/2016,9,-2,7
6/15/2016,6/13/2016,8/12/2016,60,-2,58
6/14/2016,6/14/2016,6/21/2016,7,0,7
9/29/2016,9/29/2016,12/28/2016,90,0,90
9/29/2016,9/29/2016,10/6/2016,7,0,7
9/29/2016,9/29/2016,10/6/2016,7,0,7
11/21/2016,11/17/2016,12/21/2016,34,-4,30
12/13/2016,12/13/2016,12/20/2016,7,0,7
12/13/2016,12/13/2016,12/20/2016,7,0,7
12/14/2016,12/14/2016,3/14/2017,90,0,90
12/14/2016,12/14/2016,3/14/2017,90,0,90
12/14/2016,12/14/2016,12/21/2016,7,0,7
12/14/2016,12/14/2016,1/13/2017,30,0,30
12/19/2016,12/15/2016,1/19/2017,35,-4,31
12/15/2016,12/15/2016,12/22/2016,7,0,7
12/15/2016,12/15/2016,12/22/2016,7,0,7
12/19/2016,12/15/2016,3/14/2017,89,-4,85
12/15/2016,12/15/2016,3/15/2017,90,0,90
12/15/2016,12/15/2016,3/15/2017,90,0,90
12/16/2016,12/16/2016,3/16/2017,90,0,90
12/16/2016,12/16/2016,1/13/2017,28,0,28
12/16/2016,12/16/2016,12/19/2016,3,0,3
12/19/2016,12/16/2016,12/23/2016,7,-3,4
12/21/2016,12/19/2016,1/23/2017,35,-2,33
12/21/2016,12/19/2016,1/23/2017,35,-2,33
12/21/2016,12/19/2016,12/28/2016,9,-2,7
12/27/2016,12/27/2016,1/27/2017,31,0,31
12/28/2016,12/28/2016,1/5/2017,8,0,8
5/12/2017,5/12/2017,5/19/2017,7,0,7
5/12/2017,5/12/2017,8/10/2017,90,0,90
5/12/2017,5/12/2017,8/10/2017,90,0,90
5/15/2017,5/12/2017,6/15/2017,34,-3,31
10/26/2015,10/22/2015,11/26/2015,35,-4,31
12/11/2015,12/10/2015,3/14/2016,95,-1,94
12/11/2015,12/10/2015,1/14/2016,35,-1,34
5/26/2016,5/26/2016,8/24/2016,90,0,90
6/1/2016,5/27/2016,6/8/2016,12,-5,7
5/27/2016,5/27/2016,6/27/2016,31,0,31
5/27/2016,5/27/2016,6/3/2016,7,0,7
6/14/2016,6/14/2016,6/21/2016,7,0,7
6/16/2016,6/15/2016,7/18/2016,33,-1,32
6/22/2016,6/20/2016,6/29/2016,9,-2,7
6/22/2016,6/20/2016,8/22/2016,63,-2,61
6/20/2016,6/20/2016,8/19/2016,60,0,60
6/20/2016,6/20/2016,6/27/2016,7,0,7
6/20/2016,6/20/2016,6/27/2016,7,0,7
6/21/2016,6/21/2016,9/21/2016,92,0,92
6/21/2016,6/21/2016,6/28/2016,7,0,7
6/21/2016,6/21/2016,6/28/2016,7,0,7
6/21/2016,6/21/2016,6/28/2016,7,0,7
6/23/2016,6/21/2016,9/23/2016,94,-2,92
6/23/2016,6/21/2016,7/25/2016,34,-2,32
6/23/2016,6/23/2016,6/30/2016,7,0,7
6/23/2016,6/23/2016,6/30/2016,7,0,7
6/23/2016,6/23/2016,6/30/2016,7,0,7
6/23/2016,6/23/2016,6/24/2016,1,0,1
6/24/2016,6/24/2016,6/27/2016,3,0,3
6/24/2016,6/24/2016,6/27/2016,3,0,3
6/24/2016,6/24/2016,7/1/2016,7,0,7
6/28/2016,6/28/2016,7/5/2016,7,0,7
6/28/2016,6/28/2016,7/5/2016,7,0,7
6/28/2016,6/28/2016,7/5/2016,7,0,7
